AADEN	AH AH D EH N
AALIYAH	AH L IY AY AH
AARAV	AA R AH V
AARON	EH R AH N
AB	AE B
ABAGAIL	AH B AE G EY L
ABB	AE B
ABBEY	AE B IY
ABBIE	AE B IY
ABBIGAIL	AE B AH G EY L
ABBOTT	AE B AH T
ABBY	AE B IY
ABDIEL	AE B D IY L
ABDUL	AE B D UW L
ABDULLAH	AE B D AH L AH
ABE	EY B
ABEL	EY B AH L
ABELARDO	AH B EH L ER D UW
ABIE	AE B IY
ABIGAIL	AE B AH G EY L
ABIGALE	AH B AY G EY L
ABIGAYLE	AE B AH G EY L
ABNER	AE B N ER
ABRAHAM	EY B R AH HH AE M
ABRAM	AH B R AE M
ABRIL	AH B R IH L
ACE	EY S
ACEY	EY S IY
ACHSAH	AE CH S AH
ACIE	EY S IY
ACY	EY S IY
ADA	EY D AH
ADAH	AE D AA
ADALBERTO	AE D AH L B AH R T OW
ADALINE	AE D AH L AY N
ADALYN	AE D AH L AH N
ADALYNN	AE D AH L AH N
ADAM	AE D AH M
ADAMARIS	AH D EY M EH R IY Z
ADAMS	AE D AH M Z
ADAN	EY D AH N
ADD	AE D
ADDA	AE D AH
ADDIE	AE D IY
ADDISON	AE D IH S AH N
ADDISYN	AE D AH S AH N
ADDYSON	AE D IY S AH N
ADEL	AH D EH L
ADELA	AH D EH L AH
ADELAIDE	AE D AH L EY D
ADELARD	AH D IY L AA R D
ADELBERT	AH D EH L B ER T
ADELE	AH D EH L
ADELIA	AH D IY L Y AH
ADELINA	AH D EH L AH N AH
ADELINE	AE D AH L AY N
ADELL	AH D EH L
ADELLA	AH D EH L AH
ADELLE	AH D EH L
ADELYN	AE D AH L AH N
ADEN	EY D AH N
ADILENE	AE D AH L IY N
ADIN	AH D IH N
ADINA	AA D IY N AH
ADISON	AH D IH S AO N
ADITYA	AH D IH T AY AH
ADLAI	AA D L AA IY
ADLINE	AE D L AY N
ADMIRAL	AE D M ER AH L
ADOLF	EY D AA L F
ADOLFO	AH D AA L F OW
ADOLPH	EY D AO L F
ADOLPHUS	AH D AO L F AH S
ADONIS	AH D AA N AH S
ADRAIN	AH D R EY N
ADRIA	AA D R IY AH
ADRIAN	EY D R IY AH N
ADRIANA	EY D R IY AE N AH
ADRIANE	AE D R IY EY N
ADRIANNA	AE D R IY AE N AH
ADRIANNE	AE D R IY AH N
ADRIEL	AH D R IY L
ADRIEN	AH D R AY AH N
ADRIENE	AE D R IY N
ADRIENNE	AA D R IY EH N
ADRON	AE D R AH N
ADYSON	AE D AH S AH N
AEDAN	EH D AH N
AFFIE	AE F IY
AFTON	AE F T AH N
AGATHA	AE G AH TH AH
AGGIE	AE G IY
AGNES	AE G N IH S
AGNESS	EY JH N AH S
AGUSTA	AH G AH S T AH
AGUSTIN	AH G AO S T IH N
AGUSTUS	AH G AH S T AH S
AH	AA
AHMAD	AA M AA D
AHMED	AA M AH D
AHMED(2)	AA M EH D
AIDA	AY IY D AH
AIDAN	EY D AA N
AIDEN	EY D EH N
AIDYN	EY D AH N
AILEEN	AY L IY N
AILENE	EY L IY N
AILI	EY L IY
AIMEE	EY M IY
AINSLEY	EY N S L IY
AISHA	AY SH AH
AIYANA	EY AY AH N AH
AJA	AY AH
AKEELAH	EY K IY L AH
AKEEM	EY K IY M
AKIRA	AH K IY R AH
AL	AE L
ALA	AE L AH
ALA(2)	EY L AH
ALABAMA	AE L AH B AE M AH
ALAINA	AH L EY N AH
ALAN	AE L AH N
ALANA	AA L AE N AH
ALANI	AE L AH N IY
ALANNA	AA L AA N AH
ALANNAH	AH L AE N AH
ALANZO	AH L AE N Z OW
ALAYNA	AH L EY N AH
ALBA	AE L B AH
ALBERT	AE L B ER T
ALBERTA	AE L B ER T AH
ALBERTHA	AE L B AH R TH AH
ALBERTINA	AA L B ER T IY N AH
ALBERTINE	AE L B ER T IY N
ALBERTO	AE L B ER T OW
ALBERTUS	AE L B ER T AH S
ALBIN	AE L B IH N
ALBINA	AA L B IY N AH
ALBION	AE L B IY AH N
ALBY	AE L B IY
ALCEE	AE L S IY
ALCIDE	AE L S AY D
ALCIE	AE L S AY
ALDA	AA L D AH
ALDEN	AA L D AH N
ALDO	AA L D OW
ALDONA	AE L D AH N AH
ALEAH	EY L IY AH
ALEASE	AH L IY S
ALEC	AE L IH K
ALECIA	AH L IY SH IY AH
ALECK	AE L AH K
ALEEN	AH L IY N
ALEENA	EY L IY N AH
ALEJANDRA	AE L AH JH AE N D R AH
ALEJANDRO	AA L EY Y AA N D R OW
ALEJANDRO(2)	AA L EY HH AA N D R OW
ALEK	AE L AH K
ALENA	AA L EY N AH
ALENE	AH L IY N
ALESHA	AE L AH SH AH
ALESIA	AH L IY ZH IY AH
ALESSANDRA	AE L EH S AE N D R AA
ALESSANDRO	AA L AH S AE N D R OW
ALESSANDRO(2)	AA L EY Z AA N D R OW
ALETA	AA L EH T AH
ALETHA	AH L IY TH AH
ALETHEA	AE L AH TH IY AH
ALEX	AE L AH K S
ALEXA	AH L EH K S AH
ALEXANDE	AH L EH K S AH N D
ALEXANDER	AE L IH G Z AE N D ER
ALEXANDR	AH L EH K S AH N D R
ALEXANDRA	AE L EH G Z AE N D R AH
ALEXANDRA(2)	AE L IH G Z AE N D R AH
ALEXANDRE	AE L IH K S AA N D ER
ALEXANDREA	AE L AH K S AE N D R IY AH
ALEXANDRIA	AE L AH G Z AE N D R IY AH
ALEXANDRO	AE L AH K S AE N D R OW
ALEXIA	AH L EH K S IY AH
ALEXINA	AH L EH K S AH N AH
ALEXIS	AH L EH K S IH S
ALEXUS	AH L EH K S AH S
ALEXYS	AH L EH K S AH Z
ALEXZANDER	AH L EH K S Z AE N D AH R
ALF	AE L F
ALFERD	AE L F AH R D
ALFIE	AE L F IY
ALFONSE	AE L F AA N S
ALFONSE(2)	AE L F AO N S
ALFONSO	AE L F AA N S OW
ALFONZO	AE L F AA N Z OW
ALFORD	AE L F ER D
ALFRED	AE L F R IH D
ALFREDA	AE L F R AH D AH
ALFREDO	AE L F R EY D OW
ALGER	AE L JH ER
ALGERNON	AE L JH ER N AA N
ALGIE	AO L G IY
ALGOT	AE L G AH T
ALI	AA L IY
ALIA	EY L Y AH
ALIANA	EY L IY AH N AH
ALICE	AE L IH S
ALICIA	AH L IH SH AH
ALIDA	AA L IY D AH
ALIJAH	AE L AH JH AH
ALINA	AH L IY N AH
ALINE	AH L AY N
ALISA	AH L IY S AH
ALISHA	AA L IY SH AH
ALISON	AE L IH S AH N
ALISSA	AH L IH S AH
ALISSON	EY L IY Z S AH N
ALIVIA	AH L IH V IY AH
ALIYA	EY L IY AY AH
ALIYAH	AH L IY AH
ALIZA	AE L AH Z AH
ALIZE	EY L AY Z
ALLA	AA L AH
ALLAN	AE L AH N
ALLEAN	AO L IY AH N
ALLEEN	AO L IY AH N
ALLEN	AE L AH N
ALLENA	AE L AH N AH
ALLENE	AE L IY N
ALLIE	AE L IY
ALLINE	AE L AY N
ALLISON	AE L IH S AH N
ALLISSON	AH L AY Z S AH N
ALLY	AE L AY
ALLY(2)	AH L AY
ALLYN	AE L IH N
ALLYSON	AE L IH S AH N
ALLYSSA	AE L IH S AH
ALMA	AA L M AH
ALMEDA	AA L M EY D AH
ALMEDIA	AE L M IY D IY AH
ALMER	AO L M ER
ALMETA	AE L M AH T AH
ALMINA	AE L M AH N AH
ALMIRA	AA L M IH R AH
ALMON	AA L M AH N
ALMOND	AA M AH N D
ALMUS	AE M AH S
ALMYRA	AE L M AH R AH
ALOIS	AA L OY S
ALOMA	AE L AH M AH
ALONDRA	AH L AA N D R AH
ALONSO	AH L AA N S OW
ALONZA	AH L AA N Z AH
ALONZO	AH L AA N Z OW
ALOYS	AH L OY Z
ALOYSIUS	AE L OW IH SH IH S
ALPHA	AE L F AH
ALPHEUS	AE L F IY AH S
ALPHONS	AE L F AH N Z
ALPHONSE	AE L F AA N Z
ALPHONSINE	AH L F AA N S IY N
ALPHONSO	AE L F AA N S OW
ALPHONSUS	AE L F AA N Z AH S
ALSTON	AO L S T AH N
ALTA	AA L T AH
ALTHA	AE L TH AH
ALTHEA	AE L TH IY AH
ALTIE	AE L T AY
ALTO	AE L T OW
ALTON	AO L T AH N
ALVA	AE L V AH
ALVAH	AE L V AA
ALVAN	AE L V AH N
ALVARO	AH L V AA R OW
ALVENA	AE L V AH N AH
ALVER	AE L V AH R
ALVERA	AE L V AH R AH
ALVERDA	AE L V AH R D AH
ALVERTA	AE L V AH R T AH
ALVIA	AE L V IY AH
ALVIE	AE L V AY
ALVIN	AE L V IH N
ALVINA	AE L V AY N AH
ALVIRA	AE L V AH R AH
ALVIS	AA L V IH S
ALVY	AE L V IY
ALWILDA	AE L W IH L D AH
ALWIN	AE L W IH N
ALWINA	AE L W AH N AH
ALWINE	AE L W AY N
ALYCE	AE L IH S
ALYCIA	AH L IH SH IY AH
ALYS	AE L IY Z
ALYSA	AE L AH S AH
ALYSE	AH L AY Z
ALYSHA	AE L AH SH AH
ALYSIA	AH L IH S IY AH
ALYSON	EY L IY S AH N
ALYSSA	AH L IH S AH
ALYSSIA	AH L IH SH IY AH
ALYVIA	AH L IH V IY AH
ALZINA	AE L Z AH N AH
AMA	AE M AH
AMADO	AA M AA D OW
AMALIA	AH M AA L Y AH
AMALIE	AE M AH L IY
AMANDA	AH M AE N D AH
AMANI	AE M AH N IY
AMARA	AA M AA R AH
AMARE	AH M EH R
AMARI	AA M AA R IY
AMARION	AH M EH R IY AH N
AMARIS	AE M ER IH S
AMASA	AE M AH S AH
AMAYA	AA M AA Y AH
AMBER	AE M B ER
AMBERLY	AE M B ER L IY
AMBERS	AE M B ER Z
AMBROSE	AE M B R OW Z
AMELIA	AH M IY L Y AH
AMELIE	AH M IY L AY
AMERICA	AH M EH R IH K AH
AMERICO	AH M ER IH K OW
AMERIGO	AA M ER IY G OW
AMEY	EY M IY
AMI	AA M IY
AMIAH	EY M AY AH
AMIE	AE M IY
AMIL	AH M IH L
AMIN	AA M IY N
AMINA	AE M AH N AH
AMIR	AH M IH R
AMIR(2)	AA M IH R
AMIRA	AE M AH R AH
AMIRAH	AE M AH R AH
AMIT	AA M IY T
AMIYA	EY M IY AY AH
AMIYAH	EY M IY AY AH
AMMA	AE M AH
AMMIE	AE M AY
AMMON	AE M AH N
AMON	AA M AO N
AMOS	EY M AH S
AMPARO	AE M P AH R OW
AMY	EY M IY
AMYA	AE M AY AH
ANA	AA N AH
ANA(2)	AE N AH
ANABEL	AE N AH B AH L
ANABELLA	AE N AH B EH L AH
ANABELLE	AE N AH B AH L
ANAHI	AE N AH HH IY
ANAIS	AE N EY AH S
ANANIAS	AH N EY N Y AH Z
ANASTACIA	AE N AH S T EY SH IY AH
ANASTACIO	AE N AH S T EY S IY OW
ANASTASIA	AE N AH S T EY ZH AH
ANATOLE	AE N AH T OW L
ANAYA	AA N AA Y AH
ANCEL	AH N S EH L
ANCIL	AE N S AH L
ANDERS	AE N D ER Z
ANDERSON	AE N D ER S AH N
ANDON	AE N D AH N
ANDRA	AE N D R AH
ANDRAE	AA N D R AY
ANDRE	AA N D R EY
ANDREA	AE N D R IY AH
ANDREA(2)	AA N D R EY AH
ANDREAS	AA N D R EY AH S
ANDRES	AA N D R EY Z
ANDRES(2)	AE N D R EY Z
ANDREW	AE N D R UW
ANDRIA	AE N D R IY AH
ANDY	AE N D IY
ANFERNEE	AE N F AH R N IY IY
ANGEL	EY N JH AH L
ANGELA	AE N JH AH L AH
ANGELE	AE N JH IY L
ANGELES	AE N JH AH L IH S
ANGELIA	AE N JH IY L Y AH
ANGELIC	AE N JH EH L IH K
ANGELICA	AE N JH EH L IH K AH
ANGELICA(2)	AE N JH AH L IY K AH
ANGELINA	AE N JH EH L IY N AH
ANGELINE	EY NG G IH L AY N
ANGELINE(2)	AE N JH IH L IY N
ANGELIQUE	AE N JH EH L IY K
ANGELITA	AA NG G EH L IY T AH
ANGELLA	AE N JH EH L AH
ANGELO	AE N JH AH L OW
ANGIE	AE N JH IY
ANGUS	AE NG G AH S
ANIBAL	AE N IH B AH L
ANICE	AH N AY S
ANIE	EY N AY
ANIKA	AE N AH K AH
ANISSA	AH N IH S AH
ANITA	AH N IY T AH
ANITRA	AH N IH T R AH
ANIYA	EY N IY AY AH
ANIYAH	EY N IY AY AH
ANJALI	AE N JH AH L IY
ANJANETTE	AE N JH AH N EH T
ANJELICA	AE N JH EH L AH K AH
ANN	AE N
ANNA	AE N AH
ANNABEL	AE N AH B EH L
ANNABELL	AE N AH B AH L
ANNABELLA	AE N AH B EH L AH
ANNABELLE	AE N AH B AH L
ANNALISE	AE N AH L AY Z
ANNAMAE	AE N AH M IY
ANNAMARIE	AE N AE M AH R AY
ANNE	AE N
ANNELIESE	AE N AH L IY Z
ANNEMARIE	AE N EH M AH R AY
ANNER	AE N AH R
ANNETTA	AE N EH T AH
ANNETTE	AH N EH T
ANNICE	AE N AH S
ANNIE	AE N IY
ANNIKA	AE N AH K AH
ANNIS	AE N IY Z
ANNMARIE	AE N M AH R AY
ANONA	AA N OW N AH
ANSEL	AH N S EH L
ANSLEY	AE N S L IY
ANSON	AE N S AH N
ANTHONEY	AE N T HH AH N IY
ANTHONY	AE N TH AO N IY
ANTIONE	AE N T AY OW N
ANTIONETTE	AE N T AY AO N EH T
ANTOINE	AA N T W AA N
ANTOINETTE	AE N T W AH N EH T
ANTON	AE N T AO N
ANTONE	AA N T OW N IY
ANTONETTA	AE N T AH N EH T AH
ANTONETTE	AE N T AO N EH T
ANTONIA	AE N T OW N IY AH
ANTONINA	AE N T AA N AH N AH
ANTONIO	AE N T OW N IY OW
ANTONY	AE N T AH N IY
ANTWAIN	AE N T W EY N
ANTWAN	AE N T W AA N
ANTWON	AE N T W AH N
ANWAR	AE N W AA R
ANWAR(2)	AA N W AA R
ANYA	AE N AY AH
APRIL	EY P R AH L
ARA	AE R AH
ARABELLA	AE R AH B EH L AH
ARACELI	AH R AE S AH L IY
ARACELY	AH R EY S L IY
ARAH	AE R AH
ARAMINTA	AE R AH M IH N T AH
ARBA	AA R B AH
ARBIE	AA R B AY
ARCH	AA R CH
ARCHER	AA R CH ER
ARCHIBALD	AA R CH AH B AO L D
ARCHIE	AA R CH IY
ARDATH	AA R D AH TH
ARDELIA	AA R D EH L IY AH
ARDELL	AA R D AH L
ARDELLA	AA R D EH L AH
ARDELLE	AA R D EH L
ARDEN	AA R D AH N
ARDETH	AA R D IH TH
ARDIS	AA R D IH S
ARDITH	AA R D IH TH
ARDYCE	AA R D AY S
ARELI	AE R AH L IY
ARELY	AH R IH L AY
ARETHA	ER IY TH AH
ARGIE	AA R JH AY
ARI	AA R IY
ARIA	AA R IY AH
ARIANA	AA R IY AE N AH
ARIANE	EH R IY AE N
ARIANNA	AA R IY AE N AH
ARIC	AE R IH K
ARIE	EH R IY
ARIEL	EH R IY AH L
ARIELLA	AA R IY EH L AH
ARIELLE	AH R IY L
ARIETTA	AH R IY T AH
ARIZONA	EH R IH Z OW N AH
ARJUN	AA R JH AH N
ARKIE	AA R K AY
ARLA	AA R L AH
ARLAN	AA R L AH N
ARLAND	AA R L AH N D
ARLEEN	AA R L IY N
ARLEN	AA R L AH N
ARLENA	AA R L IH N AH
ARLENE	AA R L IY N
ARLETH	AA R L AH TH
ARLETTA	AA R L EH T AH
ARLEY	AA R L IY
ARLIE	AA R L IY
ARLIN	AA R L IH N
ARLINE	AA R L AY N
ARLINGTON	AA R L IH NG T AH N
ARLIS	AA R L AH S
ARLO	AA R L OW
ARLY	AA R L IY
ARLYN	AA R L AH N
ARLYNE	AA R L AY N
ARMAN	AA R M AH N
ARMAND	AA R M AA N D
ARMANDO	AA R M AA N D OW
ARMANI	AA R M AA N IY
ARMIDA	AA R M IY D AH
ARMIN	AA R M AH N
ARMINDA	AA R M IH N D AH
ARMINTA	AA R M IH N T AH
ARMOND	AA R M AH N D
ARMSTEAD	AA R M S T EH D
ARNAV	AA R N AH V
ARNE	AA R N
ARNETT	AA R N EH T
ARNETTA	AA R N EH T AH
ARNIE	AA R N IY
ARNO	AA R N OW
ARNOLD	AA R N AH L D
ARNOLDO	AA R N OW L D OW
ARNULFO	AA R N AH L F OW
ARON	EH R AH N
ARRA	AE R AH
ARRIE	AE R AY
ARRON	AE R AH N
ARSENIO	AA R S IY N IY OW
ART	AA R T
ARTA	AA R T AH
ARTELIA	AA R T IY L Y AH
ARTHER	AA R DH AH R
ARTHOR	AA R TH AH R
ARTHUR	AA R TH ER
ARTIE	AA R T IY
ARTIS	AA R T IH S
ARTURO	AA R T UH R OW
ARVEL	AA R V EH L
ARVID	AA R V IH D
ARVIL	AA R V AH L
ARVILLA	AA R V IH L AH
ARVIN	AA R V IH N
ARVO	AA R V OW
ARYAN	AA R IY AH N
ARYANA	AH R AY AH N AH
ARYANNA	AE R AY AE N AH
ASA	AA S AH
ASBERRY	AE S B EH R IY
ASBURY	AE Z B EH R IY
ASHA	AA SH AH
ASHANTI	AH SH AE N T IY
ASHBY	AE SH B IY
ASHELY	AE SH L IY
ASHER	AE SH ER
ASHLEA	AE SH L IY AH
ASHLEE	AE SH L IY
ASHLEIGH	AE SH L EY
ASHLEY	AE SH L IY
ASHLI	AE SH L IY
ASHLIE	AE SH L AY
ASHLY	AE SH L IY
ASHLYN	AE SH L AH N
ASHLYNN	AE SH L AH N
ASHTON	AE SH T AH N
ASHTYN	AE SH T AH N
ASIA	EY ZH AH
ASON	AH S AH N
ASPEN	AE S P AH N
ASSUNTA	AE S AH N T AH
ASTRID	AE S T R IH D
ATHA	AE TH AH
ATHENA	AE TH IY N AH
ATLAS	AE T L AH S
ATTICUS	AE T IH K AH S
ATTIE	AE T IY
ATTILIO	AE T IH L IY OW
AUBRA	AO B R AH
AUBREE	AO B R IY IY
AUBREY	AO B R IY
AUBRIE	AO B R AY
AUDIE	AO D IY
AUDLEY	AO D L IY
AUDRA	AO D R AH
AUDREY	AO D R IY
AUDRIANA	AO D R IY AH N AH
AUDRIANNA	AO D R IY AE N AH
AUDRINA	AO D R AH N AH
AUDRY	AO D R IY
AUDY	AO D IY
AUGUST	AA G AH S T
AUGUST(2)	AO G AH S T
AUGUSTA	AH G AH S T AH
AUGUSTE	AO G AH S T
AUGUSTIN	AW G UW S T IY N
AUGUSTINA	AH G AH S T AH N AH
AUGUSTINE	AA G AH S T IY N
AUGUSTINE(2)	AO G AH S T IY N
AUGUSTUS	AA G AH S T AH S
AUGUSTUS(2)	AH G AH S T AH S
AURA	AO R AH
AURELIA	AH R IY L Y AH
AURELIO	AW R EY L IY OW
AURILLA	AH R IH L AH
AURORA	ER AO R AH
AURORE	AO R AH R
AURTHUR	AO R TH AH R
AUSTEN	AO S T IH N
AUSTIN	AO S T AH N
AUSTON	AO S T AH N
AUSTYN	AO S T AH N
AUTHER	AO TH ER
AUTHOR	AO TH ER
AUTHUR	AO TH AH R
AUTRY	AO T R IY
AUTUMN	AO T AH M
AVA	EY V AH
AVAH	AE V AH
AVERI	AE V AH R IY
AVERIE	AH V EH R IY
AVERY	EY V ER IY
AVIE	AH V AY
AVIS	EY V IH S
AVON	EY V AA N
AXEL	AE K S AH L
AYAAN	EY EY AH N
AYANA	EY AH N AH
AYANNA	EY AE N AH
AYDAN	EY D AH N
AYDEN	EY D AH N
AYDIN	EY D IH N
AYESHA	EY AH SH AH
AYLA	EY L AH
AYLIN	EY L AH N
AZALEE	AE Z AH L IY IY
AZARIA	AH Z AE R IY AH
AZUL	AE Z AH L
AZZIE	AE Z AY
BABE	B EY B
BABETTE	B AH B EH T
BABY	B EY B IY
BABYBOY	B EY B IY B OY
BAILEE	B EY L IY
BAILEY	B EY L IY
BAKER	B EY K ER
BALDWIN	B AO L D W AH N
BALLARD	B AE L ER D
BAMA	B AE M AH
BAMBI	B AE M B IY
BANKS	B AE NG K S
BARB	B AA R B
BARBARA	B AA R B ER AH
BARBARA(2)	B AA R B R AH
BARBIE	B AA R B IY
BARBRA	B AA R B R AH
BARNARD	B AA R N AA R D
BARNETT	B AA R N EH T
BARNEY	B AA R N IY
BARNIE	B AA R N IY
BARON	B AE R AH N
BARON(2)	B EH R AH N
BARRETT	B AE R IH T
BARRETT(2)	B EH R IH T
BARRIE	B AE R IY
BARRIE(2)	B EH R IY
BARRON	B AE R AH N
BARRY	B AE R IY
BARRY(2)	B EH R IY
BART	B AA R T
BARTHOLOMEW	B AA R TH AA L AH M Y UW
BARTLEY	B AA R T L IY
BARTON	B AA R T AH N
BASCOM	B AE S K AH M
BASIL	B AE Z AH L
BAXTER	B AE K S T ER
BAYARD	B EY ER D
BAYLEE	B EY L IY
BAYLIE	B EY L AY
BEA	B IY
BEADIE	B IY D IY
BEATRICE	B IY AH T R IH S
BEATRIX	B IY AH T R IH K S
BEATRIZ	B AH AE T R AH Z
BEAU	B OW
BEAULAH	B AH AO L AH
BEBE	B IY B IY
BECKETT	B EH K IH T
BECKHAM	B EH K HH AE M
BECKIE	B EH K IY
BECKY	B EH K IY
BEDA	B EY D AH
BEDFORD	B EH D F ER D
BEE	B IY
BEECHER	B IY CH ER
BELEN	B EH L AH N
BELIA	B AH L AY AH
BELINDA	B EH L IH N D AH
BELL	B EH L
BELLA	B EH L AH
BELLE	B EH L
BELTON	B EH L T AH N
BELVA	B EY L V AH
BEN	B EH N
BENA	B EH N AH
BENARD	B IH N AA R D
BENEDICT	B EH N AH D IH K T
BENITA	B AH N IY T AH
BENITO	B EH N IY T OW
BENITO(2)	B AH N IY T OW
BENITO(3)	B IH N IY T OW
BENJAMAN	B IH N JH EY M AH N
BENJAMEN	B IY AH N JH AE M AH N
BENJAMIN	B EH N JH AH M AH N
BENJAMINE	B IH N JH AH M AY N
BENJI	B IH N JH IY
BENJIMAN	B IH N JH AY M AH N
BENJMAN	B EH N JH M AH N
BENNETT	B EH N AH T
BENNETT(2)	B EH N IH T
BENNIE	B EH N IY
BENNY	B EH N IY
BENSON	B EH N S AH N
BENTLEY	B EH N T L IY
BENTON	B EH N T AH N
BERDIE	B IY ER D AY
BERENICE	B IH R IY N AY S
BERKLEY	B ER K L IY
BERLIN	B ER L IH N
BERNADETTE	B ER N AH D EH T
BERNADINE	B ER N AH D IY N
BERNARD	B ER N AA R D
BERNARD(2)	B ER N ER D
BERNARDINE	B IH R N AA R D AY N
BERNARDO	B ER N AA R D OW
BERNEICE	B ER N AY S
BERNETTA	B IH R N EH T AH
BERNHARD	B ER N HH AA R D
BERNICE	B ER N IY S
BERNIE	B ER N IY
BERNIECE	B IY ER N IY S
BERNITA	B ER N IY T AH
BERRY	B EH R IY
BERT	B ER T
BERTA	B ER T AH
BERTHA	B ER TH AH
BERTIE	B ER T IY
BERTINA	B IH R T IH N AH
BERTON	B ER T AH N
BERTRAM	B ER T R AH M
BERTRAND	B ER T R AH N D
BERYL	B EH R AH L
BESS	B EH S
BESSE	B EH S
BESSIE	B EH S IY
BETH	B EH TH
BETHA	B AH TH AA
BETHANN	B EH TH AE N
BETHANY	B EH TH AH N IY
BETHEL	B EH TH AH L
BETHEL(2)	B EH TH EH L
BETHZY	B EH TH Z IY
BETSEY	B EH T S IY
BETSY	B EH T S IY
BETTE	B EH T IY
BETTIE	B EH T IY
BETTINA	B AH T IY N AH
BETTY	B EH T IY
BETTYE	B IH T AY
BETTYJANE	B IH T AH JH EY N
BETTYLOU	B IH T IH L UW
BEULA	B UW L AH
BEULAH	B Y UW L AH
BEV	B EH V
BEVERLEE	B AH V AH R L IY IY
BEVERLEY	B EH V ER L IY
BEVERLY	B EH V ER L IY
BEYONCE	B IH Y AO N S EY
BIANCA	B IY AA NG K AH
BIDDIE	B IH D IY
BILAL	B AY L AH L
BILL	B IH L
BILLIE	B IH L IY
BILLY	B IH L IY
BILLYE	B AY L AY
BINA	B IY N AH
BIRD	B ER D
BIRDELLA	B AY R D EH L AH
BIRDIE	B ER D IY
BIRT	B ER T
BIRTHA	B AY R TH AA
BIRTIE	B AY R T AY
BISHOP	B IH SH AH P
BJORN	B Y AO R N
BLAIN	B L EY N
BLAINE	B L EY N
BLAIR	B L EH R
BLAISE	B L EY Z
BLAKE	B L EY K
BLANCA	B L AA NG K AH
BLANCH	B L AE N CH
BLANCHARD	B L AE N CH ER D
BLANCHE	B L AE N CH
BLANCHIE	B L AE N CH IY
BLANE	B L EY N
BLAS	B L AA S
BLAZE	B L EY Z
BLISS	B L IH S
BLOSSOM	B L AA S AH M
BLUFORD	B L UW F ER D
BO	B OW
BOB	B AA B
BOBBI	B AA B IY
BOBBIE	B AA B IY
BOBBY	B AA B IY
BOBBYE	B AA B AY
BODE	B OW D
BOLDEN	B OW L D AH N
BONITA	B OW N IY T AH
BONNIE	B AA N IY
BONNY	B AA N IY
BOOKER	B UH K ER
BOONE	B UW N
BORIS	B AO R IH S
BOSE	B OW Z
BOSS	B AA S
BOSS(2)	B AO S
BOSTON	B AA S T AH N
BOSTON(2)	B AO S T AH N
BOWMAN	B OW M AH N
BOYCE	B OY S
BOYD	B OY D
BOYSIE	B OY Z IY
BRAD	B R AE D
BRADEN	B R EY D AH N
BRADFORD	B R AE D F ER D
BRADLEY	B R AE D L IY
BRADLY	B R AE D L IY
BRADY	B R EY D IY
BRADYN	B R AE D AH N
BRAEDEN	B R EY D EH N
BRAEDON	B R EY D AA N
BRAELYN	B R IY L AH N
BRAIDEN	B R EY D AH N
BRAIN	B R EY N
BRANCH	B R AE N CH
BRANDAN	B R AE N D AH N
BRANDE	B R AE N D
BRANDEE	B R AE N D IY
BRANDEN	B R AE N D AH N
BRANDI	B R AE N D IY
BRANDIE	B R AE N D IY
BRANDIN	B R AE N D IH N
BRANDON	B R AE N D AH N
BRANDT	B R AE N T
BRANDY	B R AE N D IY
BRANDYN	B R AE N D AH N
BRANNON	B R AE N AH N
BRANSON	B R AE N S AH N
BRANT	B R AE N T
BRANTLEY	B R AE N T L IY
BRAULIO	B R AO L IY OW
BRAXTON	B R AE K S T AH N
BRAYAN	B R EY AH N
BRAYDEN	B R EY D EH N
BRAYDON	B R EY D AA N
BRAYLEN	B R EY L AH N
BRAYLON	B R EY L AH N
BREA	B R IY
BREANA	B R IY N AH
BREANN	B R IY N
BREANNA	B R IY N AH
BREANNE	B R IY N
BREE	B R IY
BRENDA	B R EH N D AH
BRENDAN	B R EH N D AH N
BRENDEN	B R EH N D AH N
BRENDON	B R EH N D AH N
BRENNA	B R EH N AH
BRENNAN	B R EH N AH N
BRENNEN	B R EH N AH N
BRENNON	B R EH N AH N
BRENT	B R EH N T
BRENTON	B R EH N T AH N
BREONNA	B R IY AA N AH
BRET	B R EH T
BRETT	B R EH T
BRIA	B R IY AH
BRIAN	B R AY AH N
BRIANA	B R IY AE N AH
BRIANA(2)	B R IY AA N AH
BRIANDA	B R AY AE N D AH
BRIANNA	B R IY AE N AH
BRIANNE	B R AY AH N
BRICE	B R AY S
BRIDGER	B R IH JH ER
BRIDGET	B R IH JH AH T
BRIDGET(2)	B R IH JH IH T
BRIDGETT	B R IH JH IH T
BRIDGETTE	B R IH JH IH T
BRIDGETTE(2)	B R IH JH IY T
BRIELLE	B R IY L
BRIEN	B R AY IH N
BRIGETTE	B R IH G EH T
BRIGID	B R IH G AH D
BRIGITTE	B R IH JH IH T
BRILEY	B R IH L IY
BRINDA	B R IH N D AH
BRION	B R AY AH N
BRIONNA	B R AY AA N AH
BRISA	B R IH S AH
BRITANY	B R IH T AH N IY
BRITNEY	B R IH T N IY
BRITNI	B R IH T N IY
BRITNY	B R IH T N IY
BRITT	B R IH T
BRITTA	B R IH T AH
BRITTANEY	B R IH T EY N IY
BRITTANI	B R IH T AH N IY
BRITTANIE	B R IH T EY N AY
BRITTANY	B R IH T AH N IY
BRITTNAY	B R IH T N EY IY
BRITTNEE	B R IH T N IY IY
BRITTNEY	B R IH T N IY
BRITTNI	B R IH T N IY
BRITTNIE	B R IH T N AY
BRITTNY	B R IH T N IY
BRITTON	B R IH T AH N
BROCK	B R AA K
BRODERICK	B R AA D ER IH K
BRODERICK(2)	B R AA D R IH K
BRODIE	B R OW T IY
BRODY	B R OW D IY
BROGAN	B R OW G AH N
BRONSON	B R AA N S AH N
BROOK	B R UH K
BROOKE	B R UH K
BROOKLYN	B R UH K L AH N
BROOKLYN(2)	B R UH K L IH N
BROOKLYNN	B R UH K L AH N
BROOKS	B R UH K S
BROWN	B R AW N
BRUCE	B R UW S
BRUNO	B R UW N OW
BRYAN	B R AY AH N
BRYANA	B R AY AH N AH
BRYANNA	B R AY AE N AH
BRYANT	B R AY AH N T
BRYCE	B R AY S
BRYCEN	B R AY S AH N
BRYLEE	B R AY L IY IY
BRYN	B R IH N
BRYNLEE	B R IH N L IY IY
BRYNN	B R IH N
BRYON	B R AY AH N
BRYSON	B R AY S AH N
BRYTON	B R IH T AH N
BUCK	B AH K
BUD	B AH D
BUDD	B AH D
BUDDIE	B AH D IY
BUDDY	B AH D IY
BUEL	B Y UW L
BUELAH	B Y UW AH L AH
BUELL	B Y UW AH L
BUENA	B UW N AH
BUFFY	B AH F IY
BUFORD	B Y UW F ER D
BULA	B Y UW L AH
BULAH	B Y UW L AH
BUNA	B Y UW N AH
BUNK	B AH NG K
BURDETTE	B ER D EH T
BUREN	B Y UH R AH N
BURGESS	B ER JH AH S
BURK	B ER K
BURKE	B ER K
BURL	B ER L
BURLEIGH	B ER L AH
BURLEY	B ER L IY
BURNELL	B ER N AH L
BURNETT	B ER N EH T
BURNEY	B ER N IY
BURNICE	B ER N AY S
BURNIE	B ER N IY
BURNS	B ER N Z
BURR	B ER
BURREL	B AH R AH L
BURRELL	B ER EH L
BURT	B ER T
BURTON	B ER T AH N
BUSH	B UH SH
BUSTER	B AH S T ER
BUTCH	B UH CH
BUTLER	B AH T L ER
BYNUM	B IH N AH M
BYRD	B ER D
BYRDIE	B AH R D AY
BYRON	B AY R AH N
CADDIE	K EY D IY
CADE	K EY D
CADEN	K EY D AH N
CADENCE	K EY D AH N S
CAEL	K IY L
CAESAR	S IY Z ER
CAIDEN	K EY D AH N
CAILYN	K EY L AH N
CAIN	K EY N
CAITLIN	K EY T L IH N
CAITLYN	K EY T L AH N
CAITLYNN	K EY T L AH N
CAL	K AE L
CALDONIA	K AE L D OW N Y AH
CALE	K EY L
CALEB	K EY L AH B
CALEIGH	K EY L EY
CALHOUN	K AE L HH UW N
CALI	K AA L IY
CALI(2)	K AE L IY
CALISTA	K AH L IH S T AH
CALLA	K AE L AH
CALLIE	K AO L IY
CALLUM	K AE L AH M
CALVIN	K AE L V AH N
CALVIN(2)	K AE L V IH N
CAM	K AE M
CAMDEN	K AE M D AH N
CAMERON	K AE M ER AH N
CAMI	K AE M IY
CAMILA	K AE M AH L AH
CAMILLA	K AH M IH L AH
CAMILLE	K AH M IY L
CAMISHA	K AE M AH SH AH
CAMMIE	K AE M IY
CAMPBELL	K AE M B AH L
CAMREN	K AE M R AH N
CAMRON	K AE M R AH N
CAMRYN	K AE M R AH N
CANDACE	K AE N D AH S
CANDI	K AE N D IY
CANDICE	K AE N D IH S
CANDIDA	K AE N D IH D AH
CANDIDO	K AE N D IY D OW
CANDIS	K AE N D IY Z
CANDY	K AE N D IY
CANDYCE	K AE N D AY S
CANNIE	K AE N IY
CANNON	K AE N AH N
CANYON	K AE N Y AH N
CAP	K AE P
CAPITOLA	K AH P IH T AH L AH
CAPPIE	K EY P IY
CAPRICE	K AH P R IY S
CAPTAIN	K AE P T AH N
CARA	K EH R AH
CAREN	K EH R AH N
CAREY	K EH R IY
CARI	K AE R IY
CARIE	K EH R IY
CARIN	K AE R IH N
CARINA	K AE R AH N AH
CARISA	K AE R AH S AH
CARISSA	K AA R IY S AH
CARL	K AA R L
CARLA	K AA R L AA
CARLEE	K AA R L IY
CARLEEN	K AA R L IY N
CARLEIGH	K AA R L EY
CARLENE	K AA R L IY N
CARLETON	K AA R L T AH N
CARLEY	K AA R L IY
CARLI	K AA R L IY
CARLIE	K AA R L IY
CARLISLE	K AA R L AY L
CARLO	K AA R L OW
CARLOS	K AA R L OW S
CARLOTA	K AA R L AH T AH
CARLOTTA	K AA R L AO T AA
CARLTON	K AA R L T AH N
CARLY	K AA R L IY
CARLYLE	K AA R L AY L
CARLYN	K AA R L AH N
CARMA	K AA R M AA
CARMEL	K AA R M EH L
CARMEL(2)	K AA R M AH L
CARMELA	K AA R M EH L AA
CARMELITA	K AA R M AH L IY T AA
CARMELLA	K AA R M EH L AH
CARMELO	K AA R M EH L OW
CARMEN	K AA R M AH N
CARMINE	K AA R M AY N
CARNELL	K AA R N AH L
CARO	K AA R OW
CAROL	K AE R AH L
CAROL(2)	K EH R AH L
CAROLANN	K AE R AH L AH N
CAROLE	K AE R AH L
CAROLE(2)	K EH R AH L
CAROLEE	K AE R AH L IY
CAROLINA	K EH R AH L AY N AH
CAROLINE	K EH R AH L AY N
CAROLYN	K EH R AH L IH N
CAROLYNE	K EH R AH L IH N
CAROLYNE(2)	K EH R AH L AY N
CAROLYNN	K AE R AH L AH N
CARON	K AA R AO N
CARRA	K AA R AH
CARRI	K AE R IY
CARRIE	K EH R IY
CARROL	K AE R AH L
CARROLL	K AE R AH L
CARROLL(2)	K EH R AH L
CARRY	K AE R IY
CARRY(2)	K EH R IY
CARSEN	K AA R S EH N
CARSON	K AA R S AH N
CARSON(2)	K AA R Z AH N
CARTER	K AA R T ER
CARY	K EH R IY
CARYL	K EH R AH L
CARYN	K AA R IH N
CAS	K AE S
CASANDRA	K AH S AE N D R AH
CASE	K EY S
CASEY	K EY S IY
CASH	K AE SH
CASIE	K EY S IY
CASIMER	K AH S AY M AH R
CASIMIR	K AE S IH M IY R
CASIMIRO	K AA S IY M IH R OW
CASON	K AE S AH N
CASPER	K AE S P ER
CASS	K AE S
CASSANDRA	K AH S AE N D R AH
CASSIDY	K AE S IH D IY
CASSIE	K AE S IY
CASSIUS	K AE S AY AH S
CASSONDRA	K AE S AA N D R AH
CASWELL	K AE Z W EH L
CATALINA	K AE T AH L IY N AH
CATHARINE	K AE TH R IH N
CATHERINE	K AE TH ER AH N
CATHERINE(2)	K AE TH ER IH N
CATHERINE(3)	K AE TH R IH N
CATHERN	K AE TH AH R N
CATHEY	K AE DH IY
CATHI	K AE TH IY
CATHIE	K AE TH IY
CATHLEEN	K AE TH L IY N
CATHRINE	K AE TH R AY N
CATHRYN	K AE TH R AH N
CATHY	K AE TH IY
CATINA	K AE T AH N AH
CATO	K EY T OW
CATRINA	K AE T R AH N AH
CAYDEN	K EY D AH N
CAYLA	K EY L AH
CAYLEE	K EY L IY IY
CEASAR	S AH S AA R
CECELIA	S IH S IY L Y AH
CECIL	S IY S AH L
CECILE	S IH S IY L
CECILIA	S IH S IY L Y AH
CECILY	S EH S AH L IY
CEDRIC	S EH D R IH K
CEDRIC(2)	S IY D R IH K
CEDRICK	S EH D R AH K
CEIL	S IY L
CELENA	CH EH L EH N AH
CELESTA	S IH L EH S T AH
CELESTE	S AH L EH S T
CELESTIA	S AH L EH S IY AH
CELESTINE	CH EH L EH S T IY N IY
CELESTINO	CH EH L EH S T IY N OW
CELIA	S IY L Y AH
CELIE	S EH L IY
CELINA	S AH L IY N AH
CELINE	S AH L IY N
CENA	S EH N AH
CEOLA	S IY AH L AH
CEPHUS	S EH F AH S
CESAR	S IY Z ER
CEYLON	S IH L AA N
CEYLON(2)	S IY L AA N
CHACE	CH EY S
CHAD	CH AE D
CHADD	CH AE D
CHADRICK	CH AE D R AH K
CHADWICK	CH AE D W IH K
CHAIM	HH AY IH M
CHAKA	CH AE K AH
CHALMER	CH AE M AH R
CHALMERS	CH AA M ER Z
CHAMP	CH AE M P
CHANA	CH AE N AH
CHANCE	CH AE N S
CHANCEY	CH AE N S IY
CHANCY	CH AE N S IY
CHANDA	CH AE N D AH
CHANDLER	CH AE N D L ER
CHANDRA	CH AE N D R AH
CHANEL	SH AH N EH L
CHANELLE	CH AE N AH L
CHANEY	CH EY N IY
CHANIE	CH EY N AY
CHANNIE	CH AE N AY
CHANNING	CH AE N IH NG
CHANTAL	CH AE N T AH L
CHANTE	CH AE N T
CHANTEL	CH AE N T AH L
CHANTELLE	CH AE N T AH L
CHARISSA	K AA R IY S AH
CHARISSE	CH AE R AH S
CHARITY	CH EH R IH T IY
CHARLA	CH AA R L AH
CHARLE	CH AA R L
CHARLEE	CH AA R L IY
CHARLEEN	CH AA R L IY N
CHARLENE	SH AA R L IY N
CHARLES	CH AA R L Z
CHARLES(2)	CH AA R AH L Z
CHARLEY	CH AA R L IY
CHARLIE	CH AA R L IY
CHARLINE	SH AA R L IY N
CHARLIZE	CH AA R L AY Z
CHARLOTTA	CH AA R L AA T AH
CHARLOTTE	SH AA R L AH T
CHARLOTTIE	SH AA R L AH T IY
CHARLS	CH AA R L Z
CHARLSIE	CH AA R L S AY
CHARLTON	CH AA R L T AH N
CHARLY	CH AA R L IY
CHARMAINE	SH AA R M EY N
CHAROLETTE	CH AE R AH L EH T
CHAS	CH AA Z
CHASE	CH EY S
CHASITY	CH EY S AH T IY
CHASTITY	CH AE S T AH T IY
CHAUNCEY	CH AO N S IY
CHAUNCY	CH AO N S IY
CHAYA	CH EY AH
CHAZ	CH AE Z
CHE	CH EY
CHELSEA	CH EH L S IY
CHELSEY	CH EH L Z IY
CHELSI	CH EH L S IY
CHELSIE	CH EH L S AY
CHELSY	CH EH L Z IY
CHER	SH EH R
CHERELLE	CH EH R AH L
CHERI	SH EH R IY
CHERIE	SH EH R IY
CHERILYN	CH EH R AH L AH N
CHERISE	CH AH R AY Z
CHERISH	CH EH R IH SH
CHERRELLE	CH EH R AH L
CHERRI	CH EH R IY
CHERRIE	CH EH R AY
CHERRY	CH EH R IY
CHERRYL	CH EH R AH L
CHERYL	SH EH R AH L
CHERYLE	CH AH R AY L
CHERYLL	CH EH R AH L
CHESLEY	CH EH S L IY
CHESSIE	CH EH S IY
CHESTER	CH EH S T ER
CHESTINA	CH EH S T AH N AH
CHET	CH EH T
CHEYANNE	CH EY AH N
CHEYENNE	SH AY EH N
CHIMERE	CH IH M AH R
CHIN	CH IH N
CHINA	CH AY N AH
CHIP	CH IH P
CHIQUITA	K IH K W IY T AH
CHIQUITA(2)	CH IH K W IY T AH
CHIQUITA(3)	CH IH K IY T AH
CHLOE	K L OW IY
CHLOIE	K L OY
CHRIS	K R IH S
CHRISSIE	K R IH S IY
CHRISSY	K R IH S IY
CHRIST	K R AY S T
CHRISTA	K R IH S T AH
CHRISTAL	K R IH S T AH L
CHRISTEEN	K R AY S T IY AH N
CHRISTEL	K R IH S T AH L
CHRISTEN	K R IH S AH N
CHRISTENA	K R IH S T AH N AH
CHRISTENE	K R IH S T IY N
CHRISTI	K R IH S T IY
CHRISTIAN	K R IH S CH AH N
CHRISTIAN(2)	K R IH S CH IH N
CHRISTIANA	K R IH S T IY AE N AH
CHRISTIE	K R IH S T IY
CHRISTIN	K R IH S T AH N
CHRISTINA	K R IH S T IY N AH
CHRISTINE	K R IH S T IY N
CHRISTION	K R IH S AH N
CHRISTOP	K R IH S T AH P
CHRISTOPER	K R IH S T OW P AH R
CHRISTOPHER	K R IH S T AH F ER
CHRISTY	K R IH S T IY
CHRYSTAL	K R IH S T AH L
CHUCK	CH AH K
CHYNA	CH IH N AH
CHYNNA	CH IH N AH
CIARA	S AY AH R AH
CIARRA	S AY AE R AH
CICELY	S IH S AH L IY
CICERO	S IH S ER OW
CIELO	S IY L OW
CIERA	S IY EH R AA
CIERRA	S IY R AH
CIJI	S IH JH IY
CILLA	S IH L AH
CINDA	S IH N D AH
CINDI	S IH N D IY
CINDY	S IH N D IY
CINNAMON	S IH N AH M AH N
CINTHIA	S IH N TH IY AH
CITLALI	S IH T L AH L IY
CITLALLI	S IH T L AE L IY
CLABE	K L EY B
CLAIBORNE	K L EY B ER N
CLAIR	K L EH R
CLAIRE	K L EH R
CLARA	K L AE R AH
CLARA(2)	K L EH R AH
CLARABELLE	K L AE R AH B AH L
CLARABELLE(2)	K L AE R AH B EH L
CLARANCE	K L AE R AH N S
CLARE	K L EH R
CLARENCE	K L EH R AH N S
CLARIBEL	K L EH R AH B EH L
CLARICE	K L ER IY S
CLARINDA	K L ER IH N D AH
CLARINE	K L EH R IY N
CLARISA	K L AE R AH S AH
CLARISSA	K L ER IH S AH
CLARK	K L AA R K
CLARKE	K L AA R K
CLARNCE	K L AA R N S
CLASSIE	K L AE S IY
CLAUD	K L AO D
CLAUDE	K L AO D
CLAUDETTE	K L OW D EH T
CLAUDIA	K L AO D IY AH
CLAUDIE	K L AO D IY
CLAUDINE	K L AO D IY N
CLAUDIO	K L AO D IY OW
CLAUDIUS	K L AO D IY AH S
CLAUS	K L AO Z
CLAY	K L EY
CLAYTON	K L EY T AH N
CLEARENCE	K L IH ER AH N S
CLEAVE	K L IY V
CLEDA	K L EH D AH
CLELL	K L EH L
CLELLA	K L EH L AH
CLEM	K L EH M
CLEMENCE	K L EH M AH N S
CLEMENS	K L EH M AH N Z
CLEMENT	K L EH M AH N T
CLEMENTE	K L AH M EH N T EY
CLEMENTE(2)	K L AH M EH N T IY
CLEMENTINA	K L AH M EH N T AH N AH
CLEMENTINE	K L EH M AH N T AY N
CLEMENTINE(2)	K L EH M AH N T IY N
CLEMIE	K L EH M IY
CLEMMA	K L EH M AH
CLEMMIE	K L EH M IY
CLEMON	K L EH M AH N
CLEO	K L IY OW
CLEOLA	K L IY AH L AH
CLEON	K L IY AH N
CLEONE	K L IY OW N
CLEORA	K L IY AH R AH
CLETA	K L EH T AH
CLETUS	K L IY T AH S
CLEVA	K L IY V AH
CLEVE	K L IY V
CLEVELAND	K L IY V L AH N D
CLEVIE	K L IY V IY
CLIDE	K L AY D
CLIFF	K L IH F
CLIFFIE	K L IH F IY
CLIFFORD	K L IH F ER D
CLIFTON	K L IH F T AH N
CLINT	K L IH N T
CLINTON	K L IH N T AH N
CLIVE	K L AY V
CLOE	K L OW
CLORA	K L AO R AH
CLOTILDA	K L AH T IH L D AH
CLOTILDE	K L AA T AH L D
CLOVIS	K L OW V IH S
CLOYD	K L OY D
CLYDA	K L IH D AH
CLYDE	K L AY D
CLYDIE	K L IH D AY
CLYTIE	K L IH T IY
COBY	K OW B IY
CODEY	K OW D IY
CODI	K OW D IY
CODIE	K OW D AY
CODY	K OW D IY
COEN	K OW IH N
COHEN	K OW AH N
COLBERT	K OW L B ER T
COLBY	K OW L B IY
COLE	K OW L
COLEEN	K AO L IY N
COLEMAN	K OW L M AH N
COLETON	K OW L T AH N
COLETTA	K OW L EH T AH
COLETTE	K OW L EH T
COLEY	K OW L IY
COLIE	K OW L AY
COLIN	K OW L IH N
COLLEEN	K AA L IY N
COLLETTE	K AH L EH T
COLLIE	K AA L IY
COLLIER	K AA L Y ER
COLLIN	K AA L IH N
COLLINS	K AA L IH N Z
COLLIS	K AA L IH S
COLON	K OW L AH N
COLONEL	K ER N AH L
COLT	K OW L T
COLTEN	K OW L T AH N
COLTER	K OW L T ER
COLTON	K OW L T AH N
COLUMBIA	K AH L AH M B IY AH
COLUMBUS	K AH L AH M B AH S
COLVIN	K OW L V IH N
COMMODORE	K AA M AH D AO R
CON	K AA N
CONARD	K AA N ER D
CONCEPCION	K AH N S EH P S IY OW N
CONCETTA	K AA N S EH T AH
CONCHA	K AA N CH AH
CONLEY	K AA N L IY
CONNER	K AA N ER
CONNIE	K AO N IY
CONNOR	K AA N ER
CONOR	K OW N ER
CONRAD	K AA N R AE D
CONSTANCE	K AA N S T AH N S
CONSTANTINE	K AA N S T AH N T IY N
CONSTANTINE(2)	K AA N S T AH N T AY N
CONSUELA	K AH N S W EY L AH
CONSUELO	K AA N S UW AH L OW
CONTINA	K AA N T IH N AH
CONWAY	K AA N W EY
COOLIDGE	K UW L IH JH
COOPER	K UW P ER
CORA	K AO R AH
CORAIMA	K OW R EY M AH
CORAL	K AO R AH L
CORALIE	K AO R AH L IY
CORBETT	K AO R B IH T
CORBIN	K AO R B IH N
CORDA	K AO R D AH
CORDARO	K ER D AA R OW
CORDELIA	K AO R D IY L IY AH
CORDELL	K AO R D EH L
CORDELLA	K AA R D EH L AH
CORDERO	K ER D EH R OW
CORDIA	K AA R D AY AH
CORDIE	K AO R D IY
COREAN	K OW R IY AH N
CORENE	K OW R AH N IY
CORETTA	K AO R EH T AH
COREY	K AO R IY
CORI	K OW R IY
CORIE	K OW R IY
CORINA	K AO R IY N AH
CORINE	K OW R AY N
CORINNA	K AO R IH N AH
CORINNE	K ER IY N
CORLISS	K AO R L IH S
CORNEL	K AO R N AH L
CORNELIA	K AO R N IY L Y AH
CORNELIOUS	K AO R N IH L IY IH S
CORNELIOUS(2)	K AO R N IY L Y IH S
CORNELIUS	K AO R N IY L Y AH S
CORNELL	K AO R N EH L
CORNIE	K AO R N IY
CORRIE	K AO R IY
CORRINA	K ER IY N AH
CORRINE	K AA R AY N
CORRY	K AO R IY
CORTEZ	K AO R T EH Z
CORTNEY	K AO R T N IY
CORWIN	K AO R W IH N
CORY	K AO R IY
COSMO	K AO Z M OW
COTY	K OW T IY
COUNCIL	K AW N S AH L
COURTLAND	K AO R T L AE N D
COURTNEY	K AO R T N IY
COY	K OY
CRAIG	K R EY G
CRAWFORD	K R AO F ER D
CREED	K R IY D
CREOLA	K R IY AH L AH
CRESSIE	K R EH S AY
CRETE	K R IY T
CRIS	K R IH S
CRISSIE	K R AY Z IY
CRISSY	K R AY Z IY
CRISTA	K R IH S T AH
CRISTAL	K R IH S T AH L
CRISTEN	K R AY Z T EH N
CRISTI	K R IH S T IY
CRISTIAN	K R IH S AH N
CRISTIN	K R AY Z T IH N
CRISTINA	K R IH S T IY N AH
CRISTINE	K R AY Z T AY N
CRISTOBAL	K R IH S T AH B AH L
CRISTOFER	K R IH S T OW F AH R
CRISTOPHER	K R IH S T AH F AH R
CRISTY	K R IH S T IY
CROCKETT	K R AA K IH T
CRUZ	K R UW Z
CRYSTA	K R IH S T AH
CRYSTAL	K R IH S T AH L
CUBA	K Y UW B AH
CULLEN	K AH L AH N
CURLEY	K ER L IY
CURT	K ER T
CURTIS	K ER T AH S
CURTIS(2)	K ER T IH S
CURTISS	K ER T IH S
CYDNEY	S IH D N IY
CYNDI	S IH N D IY
CYNTHA	S IH N TH AH
CYNTHIA	S IH N TH IY AH
CYRIL	S IH R AH L
CYRUS	S AY R AH S
DABNEY	D AE B N IY
DAFNE	D AE F N
DAGMAR	D AE G M AA R
DAGNY	D AE G N IY
DAHLIA	D AE L Y AH
DAIJA	D EY JH AH
DAIJAH	D EY JH AH
DAISEY	D EY S IY
DAISHA	D EY SH AH
DAISIE	D EY AH S IY
DAISY	D EY Z IY
DAISYE	D EY S AY
DAJA	D AE JH AH
DAKODA	D AE K AH D AH
DAKOTA	D AH K OW T AH
DAKOTAH	D AE K AH T AH
DALE	D EY L
DALIA	D AA L Y AH
DALLAS	D AE L AH S
DALLIN	D AE L AH N
DALTON	D AO L T AH N
DALVIN	D AE L V AH N
DAMARCUS	D AH M AA R K AH S
DAMARI	D AE M AH R IY
DAMARION	D EY M ER IY AH N
DAMARIS	D AH M AA R AH S
DAMEON	D EY M AO N
DAMIAN	D EY M IY AH N
DAMIEN	D EY M IY AH N
DAMION	D EY M IY AH N
DAMON	D EY M AH N
DAMOND	D AE M AH N D
DAN	D AE N
DANA	D EY N AH
DANAE	D AE N IY
DANDRE	D AE N D AH R
DANE	D EY N
DANEEN	D EY N IY AH N
DANELLE	D AH N EH L
DANETTE	D EY N EH T
DANGELO	D AE N JH AH L OW
DANI	D AA N IY
DANIA	D EY N Y AH
DANIAL	D EY N IY AH L
DANICA	D AE N IH K AH
DANIEL	D AE N Y AH L
DANIELA	D AE N Y EH L AH
DANIELE	D AE N Y EH L
DANIELLA	D AE N Y EH L AH
DANIELLE	D AE N IY EH L
DANIELLE(2)	D AE N Y EH L
DANIKA	D AE N AH K AH
DANITA	D AE N AH T AH
DANN	D AE N
DANNA	D AE N AH
DANNIE	D AE N IY
DANNIEL	D AE N IY L
DANNIELLE	D AE N IY L
DANNY	D AE N IY
DANTE	D AA N T EY
DANYEL	D AE N AY AH L
DANYELL	D AE N AY AH L
DANYELLE	D AE N AY AH L
DAPHNE	D AE F N IY
DAQUAN	D AE K W AH N
DARA	D AE R AH
DARBY	D AA R B IY
DARCI	D AA R S IY
DARCIE	D AA R K IY
DARCY	D AA R S IY
DARELL	D AE R AH L
DAREN	D AE R IH N
DARIA	D AA R IY AH
DARIAN	D AE R IY AH N
DARIANA	D AH R IY AH N AH
DARIEN	D EH R IY AH N
DARIN	D AE R IH N
DARIO	D EH R IY OW
DARION	D EH R IY AH N
DARIUS	D ER AY AH S
DARL	D AA R L
DARLA	D AA R L AH
DARLEEN	D AA R L IY N
DARLENE	D AA R L IY N
DARLINE	D AA R L AY N
DARLYNE	D AA R L AY N
DARNELL	D AA R N EH L
DAROLD	D AH R OW L D
DARON	D AE R AH N
DARREL	D EH R AH L
DARRELL	D EH R AH L
DARREN	D AA R AH N
DARRIAN	D AE R IY AH N
DARRICK	D AE R IH K
DARRIEN	D AE R IY AH N
DARRIN	D AE R IH N
DARRION	D AE R IY AH N
DARRIUS	D AE R AY AH S
DARRON	D AE R AH N
DARRY	D AA R IY
DARRYL	D EH R AH L
DARRYLE	D AE R AY L
DARRYLL	D AE R AH L
DARRYN	D AE R AH N
DARVIN	D AA R V AH N
DARWIN	D AA R W IH N
DARWYN	D AA R W AH N
DARYL	D EH R AH L
DARYLE	D AH R AY L
DARYN	D AE R AH N
DASHAWN	D AE SH AH N
DASIA	D EY ZH IY AH
DAULTON	D AO L T AH N
DAUNTE	D AO N T
DAVANTE	D AE V AH N T
DAVE	D EY V
DAVEY	D EY V IY
DAVIAN	D EY V IY AH N
DAVID	D EY V IH D
DAVIE	D EY V IY
DAVIN	D AE V IH N
DAVINA	D AA V IY N AH
DAVION	D EY V IY AH N
DAVIS	D EY V AH S
DAVIS(2)	D EY V IH S
DAVON	D AE V AH N
DAVONTA	D AH V AA N T AH
DAVONTE	D AE V AH N T
DAVY	D EY V IY
DAWN	D AO N
DAWNA	D AO N AH
DAWNE	D AO N
DAWSON	D AO S AH N
DAX	D AE K S
DAXTON	D AE K S T AH N
DAYAMI	D EY AH M IY
DAYANA	D EY AH N AH
DAYANARA	D EY AE N AH R AH
DAYLE	D EY L
DAYNA	D EY N AH
DAYNE	D EY N
DAYSE	D EY Z
DAYTON	D EY T AH N
DEACON	D IY K AH N
DEAN	D IY N
DEANA	D IY AE N AH
DEANDRA	D IY AE N D R AH
DEANDRE	D IY AE N D AH R
DEANE	D IY N
DEANGELO	D AH NG G EH L OW
DEANN	D IY AE N
DEANNA	D IY AE N AH
DEANNE	D IY AE N
DEANTE	D IY AE N T
DEASIA	D IY EY ZH IY AH
DEB	D EH B
DEBBI	D IH B IY
DEBBIE	D EH B IY
DEBBRA	D IH B R AA
DEBBY	D EH B IY
DEBERA	D IH B AH R AA
DEBI	D EH B IY
DEBORA	D EH B R AH
DEBORAH	D EH B ER AH
DEBORAH(2)	D EH B R AH
DEBORRAH	D AH B AO R AH
DEBRA	D EH B R AH
DEBRAH	D IH B R AE
DEBROAH	D IH B R OW AH
DECLAN	D IY K L AE N
DEDRA	D IH D R AA
DEDRIC	D EH D R AH K
DEDRICK	D EH D R IH K
DEE	D IY
DEEANN	D IY IY N
DEEDEE	D IY D IY
DEEGAN	D IY G AH N
DEENA	D IY AH N AA
DEETTA	D IY EH T AH
DEFOREST	D IH F AO R AH S T
DEIDRA	D IY IH D R AH
DEIDRE	D IY D R AH
DEION	D IY Y AA N
DEION(2)	D IY AA N
DEIRDRE	D IY R D R AH
DEJA	D IY JH AH
DEJA(2)	D EY ZH AA
DEJAH	D AH JH AE
DEJON	D AH JH AA N
DEJUAN	D AH JH UW W AH N
DEL	D EH L
DELANEY	D AH L EY N IY
DELANO	D IH L AA N OW
DELANO(2)	D EH L AH N OW
DELBERT	D EH L B ER T
DELCIE	D IH L S AY
DELFINA	D EH L F IY N AH
DELIA	D IY L Y AH
DELIAH	D AH L AY AH
DELILA	D EH L IY L AH
DELILAH	D AH L AY L AH
DELILAH(2)	D IH L AY L AH
DELINA	D AH L IH N AH
DELINDA	D AH L IH N D AH
DELISA	D EH L IY S AH
DELL	D EH L
DELLA	D EH L AH
DELLAR	D EH L ER
DELLE	D EH L
DELLIA	D IH L AY AH
DELLIE	D EH L IY
DELMA	D EH L M AH
DELMAR	D EH L M ER
DELMAS	D EH L M AH Z
DELMER	D EH L M ER
DELMUS	D EH L M AH S
DELOIS	D AH L OW AH S
DELORA	D EH L AO R AH
DELORES	D AH L AO R IH S
DELORIS	D EH L ER IH S
DELOS	D AH L AA Z
DELPHA	D IH L F AA
DELPHIA	D EH L F IY AH
DELPHIN	D IH L F IH N
DELPHINE	D EH L F IY N IY
DELSIE	D IH L S AY
DELTA	D EH L T AH
DELTON	D IH L T AA N
DELVIN	D EH L V IH N
DELWIN	D EH L W IH N
DEMA	D AH M AA
DEMARCO	D IH M AA R K OW
DEMARCUS	D EH M AA R K IH S
DEMARIO	D IH M AA R IY OW
DEMARION	D IY M EH R IY AH N
DEMETRA	D AH M EH T R AH
DEMETRI	D AH M EH T R IY
DEMETRIA	D IH M EH T R IY AH
DEMETRIC	D IY M EH T R IH K
DEMETRIOS	D AH M EH T R IY AH Z
DEMETRIUS	D IH M IY T R IY AH S
DEMI	D EH M IY
DEMIAN	D IY M IY AH N
DEMOND	D AH M AA N D
DEMONTE	D AH M AA N T IY
DEMPSEY	D EH M P S IY
DENA	D IY N AH
DENEEN	D IH N IY N
DENESE	D AH N IY Z
DENICE	D IH N IY S
DENINE	D IY N AY N
DENIS	D EH N IH S
DENISE	D IH N IY S
DENISHA	D AH N IH SH AH
DENISSE	D AH N IH S
DENITA	D AH N IH T AH
DENNIE	D EH N IY
DENNIS	D EH N IH S
DENNY	D EH N IY
DENTON	D EH N T AH N
DENVER	D EH N V ER
DENZEL	D EH N Z AH L
DENZELL	D IH N Z EH L
DENZIL	D EH N Z AH L
DEON	D IY AA N
DEONDRE	D IY AA N D AH R
DEONTA	D IY AA N T AH
DEONTAE	D IY AA N T IY
DEONTE	D IY AA N T
DEQUAN	D IH K W AE N
DERALD	D AH R AE L D
DERECK	D IY R EH K
DEREK	D EH R IH K
DEREON	D IY R IY AO N
DERIC	D IY R AH K
DERICK	D EH R IH K
DERIK	D EH R IH K
DERL	D AH R L
DERON	D AH R AA N
DERREK	D IH R EH K
DERRELL	D IH R EH L
DERRICK	D EH R IH K
DERWIN	D ER W IH N
DERYL	D AH R IH L
DESEAN	D AH S IY AH N
DESHAUN	D AH SH AO N
DESHAWN	D AH SH AO N
DESI	D EH Z IY
DESIRAE	D AH S IH R IY
DESIREE	D EH S AY R IY
DESMOND	D EH Z M AH N D
DESSA	D IH S AA
DESSIE	D IH S AY
DESTANY	D IH S T EY N IY
DESTIN	D EH S T IH N
DESTINEE	D EH S T AH N IY
DESTINEY	D EH S T AH N IY
DESTINI	D IH S T IH N IY
DESTINY	D EH S T AH N IY
DESTRY	D EH S T R IY
DEVAN	D EH V AH N
DEVANTE	D AH V AE N T
DEVAUGHN	D EH V AO N
DEVEN	D IY V AH N
DEVIN	D EH V IH N
DEVON	D EH V AH N
DEVONTA	D AH V AA N T AH
DEVONTAE	D AH V AA N T IY
DEVONTE	D AH V AA N T
DEVYN	D AH V IH N
DEWARD	D IY W AO R D
DEWAYNE	D IH W EY N
DEWAYNE(2)	D IY W EY N
DEWEY	D UW IY
DEWITT	D EH W IH T
DEXTER	D EH K S T ER
DEYANIRA	D IY Y AE N AH R AH
DEZZIE	D IH Z AY
DIALLO	D AY AE L OW
DIAMOND	D AY M AH N D
DIAN	D AY AH N
DIANA	D AY AE N AH
DIANDRA	D AY AE N D R AH
DIANE	D AY AE N
DIANN	D AY AH N
DIANNA	D AY AE N AH
DIANNE	D AY AE N
DICIE	D AY S IY
DICK	D IH K
DICKIE	D IH K IY
DICY	D AY S IY
DIEGO	D IY EY G OW
DIJON	D IY ZH AA N
DIJON(2)	D IY ZH OW N
DILLAN	D IH L AH N
DILLARD	D IH L ER D
DILLARD(2)	D IH L AA R D
DILLARD(3)	D IH L AH D
DILLIE	D IH L IY
DILLION	D IH L Y AH N
DILLON	D IH L AH N
DIMITRI	D IH M IY T R IY
DIMITRIOS	D IH M IY T R IY OW S
DIMPLE	D IH M P AH L
DINA	D IY N AH
DINAH	D AY N AH
DINK	D IH NG K
DINO	D IY N OW
DION	D AY AH N
DION(2)	D IY AO N
DIONE	D IY AA N
DIONICIO	D AY AH N IH S IY OW
DIONNE	D IY AA N
DIONTE	D AY AH N T
DIRK	D ER K
DIXIE	D IH K S IY
DIXON	D IH K S AH N
DIYA	D AY AY AH
DJUANA	JH UW W AH N AH
DJUNA	JH UW N AH
DOC	D AA K
DOCIA	D OW SH IY AH
DOCK	D AA K
DOCTOR	D AA K T ER
DOCTOR(2)	D AO K T ER
DOLA	D OW L AH
DOLL	D AA L
DOLLIE	D AA L IY
DOLLY	D AA L IY
DOLLYE	D AA L AY
DOLORES	D AH L AO R IH S
DOLORIS	D OW L ER IY Z
DOLPH	D OW L F
DOLPHUS	D OW L F AH S
DOMENIC	D OW M AH N IH K
DOMENICA	D AH M EH N AH K AH
DOMENICK	D AA M IH N IH K
DOMENICO	D OW M EY N IY K OW
DOMINGA	D AH M IH N G AH
DOMINGO	D OW M IH NG G OW
DOMINGO(2)	D AH M IH NG G OW
DOMINIC	D AA M AH N IH K
DOMINICK	D AA M AH N IH K
DOMINIK	D AH M IH N IH K
DOMINIQUE	D AO M IH N IY K
DOMINQUE	D AA M AH NG K W
DOMONIQUE	D AA M AH N AH K
DON	D AA N
DONA	D OW N AH
DONACIANO	D AA N AH S IY AH N OW
DONAL	D AA N AH L
DONALD	D AA N AH L D
DONAT	D OW N AH T
DONATO	D AH N AA T OW
DONAVAN	D AA N AH V AE N
DONAVON	D AA N AH V AH N
DONDRE	D AA N D AH R
DONELL	D AA N AH L
DONIA	D OW N IY AH
DONIE	D AA N IY
DONITA	D AA N AH T AH
DONN	D AA N
DONNA	D AA N AH
DONNELL	D AA N IH L
DONNIE	D AA N IY
DONNY	D AA N IY
DONOVAN	D AA N AH V AH N
DONTA	D AA N T AH
DONTAE	D AA N T IY
DONTE	D AA N T
DORA	D AO R AH
DORATHEA	D AH R AE TH IY AH
DORATHY	D AO R AH TH IY
DORCAS	D AO R K AH S
DOREEN	D AO R IY N
DORENE	D AO R IY N
DORETHA	D AO R AH TH AH
DORETTA	D AH R EH T AH
DORI	D AO R IY
DORIAN	D AO R IY AH N
DORINDA	D AO R IY N D AH
DORINE	D AO R IY N IY
DORIS	D AO R AH S
DORIS(2)	D AO R IH S
DORIS(3)	D AA R AH S
DORIS(4)	D AA R IH S
DORLA	D AO R L AH
DORMAN	D AO R M AH N
DOROTHA	D AO R AH TH AH
DOROTHEA	D AO R AH TH IY AH
DOROTHY	D AO R AH TH IY
DOROTHY(2)	D AO R TH IY
DORR	D AO R
DORRIS	D AO R IH S
DORSEY	D AO R S IY
DORTHA	D AO R TH AH
DORTHEA	D AO R DH IY AH
DORTHEY	D AO R TH IY
DORTHY	D AO R TH IY
DOSHA	D AA SH AH
DOSHIA	D AA SH IY AH
DOSHIE	D AA SH AY
DOSIA	D OW S IY AH
DOSS	D AO S
DOSSIE	D UW Z IY
DOT	D AA T
DOTTIE	D AA T IY
DOTTY	D AA T IY
DOUG	D AH G
DOUGLAS	D AH G L AH S
DOUGLASS	D AH G L AH S
DOVE	D AH V
DOVE(2)	D OW V
DOVIE	D AH V IY
DOW	D AW
DOYLE	D OY L
DOZIER	D OW Z IY ER
DRAKE	D R EY K
DRAVEN	D R EY V AH N
DREMA	D R EH M AH
DREW	D R UW
DRUCILLA	D R UW S IH L AH
DRURY	D R UW R IY
DRUSILLA	D R UW S IH L AH
DUANE	D W EY N
DUARD	D Y UW AH R D
DUDLEY	D AH D L IY
DUFF	D AH F
DUKE	D UW K
DULCE	D AH L S
DULCIE	D AH L K IY
DUNCAN	D AH NG K AH N
DURELL	D Y UW R AH L
DURRELL	D UH R AH L
DURWARD	D ER W ER D
DURWOOD	D AH R W UW D
DUSTAN	D AH S T AH N
DUSTIN	D AH S T IH N
DUSTY	D AH S T IY
DUWAYNE	D UW W EY N
DWAIN	D W EY N
DWAINE	D W EY N
DWAN	D W AA N
DWANE	D W EY N
DWAYNE	D W EY N
DWIGHT	D W AY T
DWYANE	D W AY EY N
DYAN	D AY AE N
DYLAN	D IH L AH N
DYLLAN	D IH L AH N
DYLON	D IH L AH N
EAN	IY AH N
EARL	ER L
EARLE	ER L
EARLEAN	IH ER L IY N
EARLENE	ER L IY N
EARLEY	ER L IY
EARLIE	ER L IY
EARLINE	ER L AY N
EARLY	ER L IY
EARNEST	ER N IH S T
EARNESTINE	AH R N AH S T AY N
EARTHA	ER TH AH
EASTER	IY S T ER
EASTON	IY S T AH N
EATHEL	IY TH AH L
EBB	EH B
EBBA	EH B AH
EBBIE	EH B IY
EBEN	EH B AH N
EBENEZER	EH B IH N IY Z ER
EBER	EH B ER
EBERT	EH B ER T
EBONI	EH B AH N IY
EBONY	EH B AH N IY
ECHO	EH K OW
ED	EH D
EDA	IY D AH
EDD	EH D
EDDIE	EH D IY
EDDY	EH D IY
EDEN	IY D AH N
EDGAR	EH D G ER
EDGARDO	EH JH ER D UW
EDIE	EH D IY
EDISON	EH D IH S AH N
EDITH	IY D IH TH
EDLA	EH D L AH
EDMON	EH D M AH N
EDMOND	EH D M AH N D
EDMONIA	EH D M OW N Y AH
EDMUND	EH D M AH N D
EDNA	EH D N AH
EDNAH	EH D N AH
EDRA	EH D R AH
EDRIE	EH D R AY
EDRIS	IH D R IY S
EDSEL	EH D S AH L
EDSON	EH D S AH N
EDUARDO	EH D W AA R D OW
EDW	EH D W
EDWARD	EH D W ER D
EDWARDO	EH D W AO R D OW
EDWIN	EH D W AH N
EDWIN(2)	EH D W IH N
EDWINA	EH D W IY N AH
EDYTH	EH D IH TH
EDYTHE	EH D AY DH
EFFA	EH F AH
EFFIE	EH F IY
EFRAIN	EH F R EY N
EFREM	EH F R AH M
EFREN	EH F R AH N
EGBERT	EH G B ER T
EILEEN	AY L IY N
EINAR	AY N ER
EINO	IY N OW
EITHEL	IY TH AH L
ELA	EH L AH
ELAINA	IH L EY N AH
ELAINE	IH L EY N
ELAINE(2)	AH L EY N
ELAINE(3)	IY L EY N
ELAM	EH L AH M
ELANA	EH L AH N AH
ELAYNE	IH L EY N
ELBA	EH L B AH
ELBERT	EH L B ER T
ELBERTA	EH L B EH R T AH
ELBRIDGE	EH L B R AH JH
ELBY	EH L B IY
ELDA	EH L D AH
ELDEN	EH L D AH N
ELDER	EH L D ER
ELDON	IH L D AA N
ELDORA	EH L D AO R AH
ELDRED	EH L D ER D
ELDRIDGE	EH L D R IH JH
ELEANOR	EH L AH N AO R
ELEANOR(2)	EH L AH N ER
ELEANORA	EH L AH N AO R AH
ELEANORE	EH L AH N AO R
ELEASE	IY L IY Z
ELECTA	AH L EH K T AH
ELENA	EH L AH N AA
ELENA(2)	EH L EY N AA
ELENI	EH L AH N IY
ELENOR	EH L AH N AH R
ELENORA	AH L EH N AH R AH
ELENORE	EH L IH N ER
ELEONORA	IY L IY AA N AH R AH
ELEONORE	EH L IY AH N AO R IY
ELEX	EH L AH K S
ELFIE	EH L F IY
ELFREDA	EH L F R EH D AH
ELFRIEDA	EH L F R IY D AH
ELGIE	EH L JH IY
ELGIN	EH L JH IH N
ELI	IY L AY
ELIA	AH L AY AH
ELIAN	IY L IY AH N
ELIANA	IY L IY AH N AH
ELIANNA	IY L IY AE N AH
ELIAS	AH L AY AH S
ELICK	EH L IH K
ELIDA	EH L AH D AH
ELIE	EH L IY
ELIEZER	IY L IY Z AH R
ELIGA	EH L AH G AH
ELIGAH	EH L AH G AH
ELIGE	AH L AY JH
ELIHU	EH L IH HH UW
ELIJAH	EH L AY JH AH
ELIJAH(2)	IY L AY JH AH
ELINOR	EH L IH N ER
ELINORE	EH L IY N AO R IY
ELIOT	EH L IY AH T
ELISA	AH L IY S AH
ELISA(2)	AH L IY Z AH
ELISABETH	IH L IH Z AH B IH TH
ELISE	AH L IY S
ELISEO	AH L IH S IY OW
ELISHA	EH L IH SH AH
ELISSA	EH L IY S AH
ELIZA	IH L AY Z AH
ELIZABET	AH L IH Z AH B AH T
ELIZABETH	IH L IH Z AH B AH TH
ELIZABETH(2)	IH L IH Z AH B IH TH
ELIZAH	EH L AH Z AH
ELIZBETH	AH L IH Z AH TH
ELIZEBETH	AH L IH Z AH B AH TH
ELL	EH L
ELLA	EH L AH
ELLAMAE	EH L AH M IY
ELLAR	EH L AH R
ELLE	EH L
ELLEN	EH L AH N
ELLER	EH L ER
ELLERY	EH L ER IY
ELLIANA	EH L IY AH N AH
ELLIE	EH L IY
ELLIOT	EH L IY AH T
ELLIOTT	EH L IY AH T
ELLIS	EH L IH S
ELLISON	EH L IH S AH N
ELLSWORTH	EH L Z W ER TH
ELLWOOD	EH L W UH D
ELLYN	EH L IH N
ELMA	EH L M AH
ELMER	EH L M ER
ELMINA	EH L M AH N AH
ELMIRA	EH L M AY R AH
ELMIRE	EH L M AY ER
ELMO	EH L M OW
ELMORE	EH L M AO R
ELMYRA	EH L M AH R AH
ELNA	IH L N AA
ELNORA	EH L N AO R AH
ELODIE	AH L OW D AY
ELOIS	EH L OW AH S
ELOISA	EH L OY S AH
ELOISE	IH L OY Z
ELOISE(2)	EH L OW IY Z
ELON	EH L AH N
ELONZO	AH L AA N Z OW
ELOUISE	EH L AH W IY Z
ELOY	IY L OY
ELROY	IH L R OY
ELSA	EH L S AH
ELSE	EH L S
ELSIE	EH L S IY
ELSWORTH	EH L Z W ER TH
ELTA	EH L T AH
ELTON	EH L T AH N
ELVA	EH L V AH
ELVERA	EY L V EH R AH
ELVIA	EH L V IY AH
ELVIE	EH L V IY
ELVIN	EH L V IH N
ELVINA	EH L V IY N AH
ELVIRA	EH L V AY R AH
ELVIS	EH L V IH S
ELWANDA	EH L W AA N D AH
ELWIN	EH L W IH N
ELWOOD	EH L W UH D
ELWYN	EH L W AH N
ELY	IY L AY
ELYSE	EH L AY S
ELYSSA	AH L IH S AH
ELZA	EH L Z AH
ELZADA	EH L Z AH D AH
ELZIE	EH L Z AY
ELZY	EH L Z IY
EMA	IY M AH
EMALINE	IH M AH L AY N
EMANUEL	IH M AE N Y UW AH L
EMELIA	AH M IY L Y AH
EMELIE	EH M AH L IY
EMELINE	EH M IH L AY N
EMELY	IH M L IY
EMERALD	EH M R AH L D
EMERALD(2)	EH M ER R AH L D
EMERSON	EH M ER S AH N
EMERY	EH M ER IY
EMETT	AH M EH T
EMIL	EH M IY L
EMILE	EY M IY L
EMILEE	IY M AH L IY IY
EMILIA	AH M IY L IY AH
EMILIANO	AH M AH L IY AH N OW
EMILIE	EH M AH L IY
EMILIO	AH M IY L IY OW
EMILY	EH M IH L IY
EMIT	IH M IH T
EMMA	EH M AH
EMMALEE	IH M EY L IY
EMMALINE	EH M AA L IY N IY
EMMANUEL	IH M AE N Y UW AH L
EMMER	EH M ER
EMMET	EH M IH T
EMMETT	EH M IH T
EMMIE	EH M IY
EMMIT	EH M IH T
EMMITT	EH M IH T
EMMONS	EH M AH N Z
EMMY	EH M IY
EMOGENE	EH M AH G IY N
EMORY	EH M ER IY
EMRY	EH M R IY
ENA	EH N AH
ENCARNACION	EH N K AA R N AA S Y AO N
ENID	IY N IH D
ENNIS	EH N IH S
ENOCH	IY N AH K
ENOLA	IH N OW L AH
ENOS	IY N AH S
ENRICO	EH N R IY K OW
ENRIQUE	EH N R IY K EY
ENRIQUETA	IH N R IH K W AH T AH
ENZO	EH N Z OW
EOLA	IY AH L AH
EPHRAIM	IY F R AH M
EPHRAM	EH F R AH M
EPHRIAM	EH F R IY AH M
EPIFANIO	EH P AH F EY N IY OW
EPPIE	EH P AY
EPSIE	EH P S AY
ERA	EH R AH
ERA(2)	IH R AH
ERASMO	AH R AE Z M OW
ERASMUS	IH R AE Z M AH S
ERASTUS	IH R AE S T AH S
ERBY	ER B IY
ERIC	EH R IH K
ERICA	EH R IH K AH
ERICH	EH R IH K
ERICK	EH R IH K
ERICKA	EH R IH K AH
ERIE	IH R IY
ERIK	EH R IH K
ERIKA	EH R IH K AH
ERIN	EH R IH N
ERIS	IY R AH S
ERLA	AH R L AH
ERLAND	ER L AH N D
ERLE	EH R L AH
ERLENE	ER L IY N
ERLINDA	AH R L IH N D AH
ERLINE	ER L AY N
ERLING	ER L IH NG
ERMA	ER M AH
ERMINA	ER M IY N AH
ERMINE	ER M AH N
ERNA	ER N AH
ERNEST	ER N AH S T
ERNEST(2)	ER N IH S T
ERNESTINA	AH R N EH S T AH N AH
ERNESTINE	ER N IH S T IY N
ERNESTO	ER N EH S T OW
ERNIE	ER N IY
ERNST	ER N S T
ERROL	EH R AH L
ERVIN	ER V IH N
ERVING	ER V IH NG
ERWIN	ER W IH N
ERYKAH	EH R IY K AH
ERYN	EH R AH N
ESAU	IY S AO
ESCO	EH S K OW
ESEQUIEL	EH S AH K W IY L
ESKER	EH S K ER
ESLEY	EH Z L IY
ESMERALDA	EH Z M AH R AE L D AH
ESPERANZA	EH S AH R AE N Z AH
ESSA	EH S AH
ESSENCE	EH S AH N S
ESSEX	EH S IH K S
ESSIE	EH S IY
ESTA	EH S T AH
ESTEBAN	EH S T AH B AA N
ESTEFANI	EH S T EH F AH N IY
ESTEFANIA	EH S T AH F EY N Y AH
ESTEFANY	EH S T EH F AH N IY
ESTEL	EH S T AH L
ESTELA	EH S T AH L AH
ESTELL	EH S T AH L
ESTELLA	EH S T EH L AH
ESTELLE	EH S T EH L
ESTER	EH S T ER
ESTES	EH S T IY Z
ESTEVAN	EH S T AH V AH N
ESTHER	EH S T ER
ESTIE	EH S T AY
ESTILL	EH S T IY L
ESTON	EH S T AH N
ESTRELLA	EH S T R EH L AH
ETHA	EH TH AH
ETHAN	IY TH AH N
ETHEL	EH TH AH L
ETHELBERT	EH TH IH L B ER T
ETHELENE	EH TH AH L IY N
ETHELYN	EH TH IH L IH N
ETHEN	EH TH AH N
ETHER	IY TH ER
ETHIE	EH TH AY
ETHYL	EH TH AH L
ETHYLE	AH TH AY L
ETNA	EH T N AH
ETTA	EH T AH
ETTER	EH T ER
ETTIE	EH T IY
EUDORA	Y UW D AO R AH
EUGENE	Y UW JH IY N
EUGENIA	Y UW JH IY N IY AH
EUGENIE	Y UW JH IY N IY
EUGENIO	Y UW JH IY N IY OW
EULA	Y UW L AH
EULAH	Y UW L AH
EULALIA	Y UW L EY L Y AH
EULALIE	Y UW L EY L AY
EUNA	Y UW N AH
EUNICE	Y UW N AH S
EUNICE(2)	Y UW N IH S
EUPHEMIA	Y UW F IY M IY AH
EURA	Y UW R AH
EUSEBIO	Y UW S IY B IY OW
EUSTACE	Y UW S T AH S
EVA	EY V AH
EVA(2)	IY V AH
EVALENA	AH V AE L AH N AH
EVALINE	EH V AH L AY N
EVALYN	EH V AH L AH N
EVAN	EH V AH N
EVANDER	IY V AE N D ER
EVANGELINA	EH V AH N JH EH L AH N AH
EVANGELINE	IH V AE N JH IH L AY N
EVANS	EH V AH N Z
EVE	IY V
EVELENA	AH V EH L AH N AH
EVELIN	EH V AH L AH N
EVELINA	EH V EH L IY N AH
EVELINE	EH V AH L IH N
EVELYN	EH V AH L AH N
EVELYN(2)	EH V AH L IH N
EVELYNE	EH V AH L AY N
EVER	EH V ER
EVERET	EH V AH R AH T
EVERETT	EH V ER AH T
EVERETT(2)	EH V R AH T
EVERETTE	EH V ER EH T
EVERT	IH V ER T
EVERTT	EH V AH R T
EVETTE	IY V EH T
EVIA	IY V IY AH
EVIE	IY V IY
EVITA	EH V IY T AH
EVON	EH V AH N
EVONNE	EH V AA N
EWALD	Y UW AH L D
EWART	Y UW ER T
EWELL	Y UW AH L
EWIN	Y UW AH N
EWING	Y UW IH NG
EXA	IH G Z AA
EXIE	IH G Z AY
EZEKIEL	EH Z EH K IY AH L
EZELL	EH Z EH L
EZEQUIEL	EH Z AH K W IY L
EZRA	EH Z R AH
EZZARD	EH Z AH R D
FABIAN	F EY B IY AH N
FABIOLA	F EY B IY AH L AH
FAE	F AY
FAIRY	F EH R IY
FAITH	F EY TH
FALLON	F AE L AH N
FALON	F AE L AH N
FANNIE	F AE N IY
FANNY	F AE N IY
FANNYE	F AE N AY
FARAH	F EH R AH
FARON	F EH R AH N
FARRAH	F EH R AH
FARRELL	F EH R IH L
FARRIS	F EH R IH S
FATE	F EY T
FATIMA	F AE TH IH M AH
FATIMA(2)	F AE T IH M AH
FAUSTINO	F AO S T IY N OW
FAWN	F AO N
FAY	F EY
FAYE	F EY
FAYETTE	F EY EH T
FED	F EH D
FEDERICO	F EH D ER IY K OW
FELECIA	F AH L IY SH IY AH
FELICE	F AH L IY S
FELICIA	F AH L IY SH AH
FELICIE	F EH L AH S AY
FELICITAS	F AH L IH S AH T AH Z
FELICITY	F IH L IH S AH T IY
FELIPA	F EH L AH P AH
FELIPE	F AH L IY P
FELISHA	F EH L AH SH AH
FELIX	F IY L IH K S
FELTON	F EH L T AH N
FENTON	F EH N T AH N
FERD	F ER D
FERDINAND	F ER D IH N AE N D
FERDINAND(2)	F ER D IH N AE N
FERMAN	F ER M AH N
FERN	F ER N
FERNAND	F ER N AE N D
FERNAND(2)	F ER N AA N
FERNAND(3)	F ER N AA N D
FERNANDA	F ER N AE N D AH
FERNANDA(2)	F ER N AA N D AH
FERNANDO	F ER N AE N D OW
FERNANDO(2)	F ER N AA N D OW
FERNE	F AH R N
FERRELL	F EH R IH L
FERRIS	F EH R IH S
FESTUS	F EH S T AH S
FIDEL	F IH D EH L
FIDELIA	F IH D IY L Y AH
FIDENCIO	F AH D EH N S IY OW
FIELDING	F IY L D IH NG
FILOMENA	F IH L AH M IY N AH
FINIS	F AY N IY Z
FINLEY	F IH N L IY
FINN	F IH N
FINNEGAN	F IH N AH G AH N
FIONA	F IY OW N AH
FIRMAN	F ER M AH N
FISHER	F IH SH ER
FITZGERALD	F IH T S JH EH R AH L D
FITZHUGH	F IH T S HH Y UW
FLAVIA	F L AE V IY AH
FLEDA	F L EH D AH
FLEET	F L IY T
FLEETA	F L IY T AH
FLEM	F L EH M
FLEMING	F L EH M IH NG
FLETA	F L IY T AH
FLETCHER	F L EH CH ER
FLINT	F L IH N T
FLO	F L OW
FLONNIE	F L AA N AY
FLOR	F L AO R
FLORA	F L AO R AH
FLORANCE	F L AO R AH N S
FLORENCE	F L AO R AH N S
FLORENCIO	F L AH R EH N S IY OW
FLORENE	F L AH R IY N
FLORENTINO	F L AO R EH N T IY N OW
FLORETTA	F L AH R EH T AH
FLORIAN	F L AO R IY AH N
FLORIDA	F L AO R AH D AH
FLORIDA(2)	F L AO R IH D AH
FLORIDA(3)	F L AA R AH D AH
FLORIDA(4)	F L AA R IH D AH
FLORIE	F L OW R IY
FLORINE	F L AO R IY N
FLORRIE	F L AO R IY
FLOSSIE	F L AO S IY
FLOY	F L OY
FLOYD	F L OY D
FOCH	F AA CH
FONDA	F AA N D AH
FORD	F AO R D
FOREST	F AO R AH S T
FOREST(2)	F AO R IH S T
FORREST	F AO R AH S T
FOSTER	F AA S T ER
FOUNT	F AW N T
FOY	F OY
FRAN	F R AE N
FRANC	F R AE NG K
FRANCES	F R AE N S IH S
FRANCESCA	F R AE N CH EH S K AH
FRANCESCO	F R AE N CH EH S K OW
FRANCIES	F R AH N S IY Z
FRANCINA	F R AE N S AH N AH
FRANCINE	F R AE N S IY N
FRANCIS	F R AE N S AH S
FRANCIS(2)	F R AE N S IH S
FRANCISCA	F R AE N S IH S AH
FRANCISCO	F R AE N S IH S K OW
FRANCISQUI	F R AE N S IH S W IY
FRANCO	F R AE NG K OW
FRANK	F R AE NG K
FRANKIE	F R AE NG K IY
FRANKLIN	F R AE NG K L IH N
FRANKLYN	F R AE NG K L IH N
FRANZ	F R AE N Z
FRAZIER	F R EY ZH ER
FRED	F R EH D
FREDA	F R EH D
FREDDIE	F R EH D IY
FREDDY	F R EH D IY
FREDERIC	F R EH D R IH K
FREDERICA	F R EH D ER IY K AH
FREDERICK	F R EH D R IH K
FREDERICK(2)	F R EH D ER IH K
FREDERICKA	F R EY D EH R IY K AH
FREDIE	F R IY D AY
FREDRIC	F R EH D R IH K
FREDRICK	F R EH D R IH K
FREDY	F R IY D IY
FREEDA	F R IY D AH
FREEMAN	F R IY M AH N
FREIDA	F R IY D AH
FREMONT	F R IY M AA N T
FRENCH	F R EH N CH
FRIDA	F R IY D AH
FRIEDA	F R IY D AH
FRIEND	F R EH N D
FRITZ	F R IH T S
FRONA	F R AA N AH
FRONIA	F R OW N Y AH
FRONIE	F R OW N AY
FRONNIE	F R AA N AY
FULLER	F UH L ER
FULTON	F UH L T AH N
FUMIKO	F Y UW M AH K OW
FURMAN	F ER M AE N
GABE	G EY B
GABRIEL	G EY B R IY AH L
GABRIELA	G AA B R IY EH L AA
GABRIELLA	G AA B R IY EH L AA
GABRIELLE	G AA B R IY EH L
GAEL	G EY L
GAETANO	G AY T AA N OW
GAGE	G EY JH
GAIGE	G EY JH
GAIL	G EY L
GAINES	G EY N Z
GAITHER	G EY TH ER
GALE	G EY L
GALEN	G EY L AH N
GALILEA	G AH L IH L IY AH
GANNON	G AE N AH N
GARDNER	G AA R D N ER
GARETT	G AE R IH T
GAREY	G AE R IY
GARFIELD	G AA R F IY L D
GARLAND	G AA R L AH N D
GARNER	G AA R N ER
GARNET	G AA R N AH T
GARNETT	G AA R N IH T
GAROLD	G AH R OW L D
GARRET	G EH R IH T
GARRETT	G AE R IH T
GARRETT(2)	G EH R IH T
GARRICK	G EH R IH K
GARRISON	G AE R IH S AH N
GARRY	G AE R IY
GARRY(2)	G EH R IY
GARTH	G AA R TH
GARVIN	G AA R V IH N
GARY	G EH R IY
GARY(2)	G AE R IY
GASPER	G AE S P ER
GASTON	G AE S T AH N
GAUGE	G EY JH
GAVEN	G EY V AH N
GAVIN	G AE V IH N
GAVYN	G AE V AH N
GAY	G EY
GAYE	G EY
GAYLA	G EY L AH
GAYLE	G EY L
GAYLEN	G EY L AH N
GAYLENE	G EY L IY N
GAYLON	G EY L AH N
GAYLORD	G EY L AO R D
GAYNELL	G EY N AH L
GEARLD	JH AH R L D
GEARLDINE	JH AH R L D AY N
GEARY	G IH R IY
GEE	JH IY
GEMMA	JH EH M AH
GENA	JH EH N AH
GENARO	JH EH N AH R OW
GENE	JH IY N
GENERAL	JH EH N ER AH L
GENERAL(2)	JH EH N R AH L
GENESIS	JH EH N AH S AH S
GENEVA	JH AH N IY V AH
GENEVIEVE	JH EH N AH V IY V
GENEVRA	JH AH N EH V R AH
GENIE	JH IY N IY
GENNARO	JH AH N AA R OW
GENNIE	JH EH N AY
GENO	JH IY N OW
GENOVEVA	JH AH N AA V AH V AH
GEO	JH IY OW
GEOFF	JH EH F
GEOFFREY	JH EH F R IY
GEORGANNA	JH IY AH R G AE N AH
GEORGE	JH AO R JH
GEORGEANN	JH IY AH R JH IY N
GEORGEANNA	JH IY AH R JH IY N AH
GEORGENE	JH AO R JH IY N
GEORGETTA	JH IY AH R JH EH T AH
GEORGETTE	JH AO R JH EH T
GEORGIA	JH AO R JH AH
GEORGIANA	JH AO R JH IY AE N AH
GEORGIANN	JH IY AO R JH IY AH N
GEORGIANNA	JH IY AO R JH IY AE N AH
GEORGIE	JH AO R JH IY
GEORGINA	JH AO R JH IY N AH
GEORGINE	JH AO R JH IY N
GEOVANNI	JH IY AH V AE N IY
GERALD	JH EH R AH L D
GERALDINE	JH EH R AH L D IY N
GERALDO	JH ER AA L D OW
GERALDO(2)	HH ER AA L D OW
GERALYN	JH EH R AH L AH N
GERARD	JH ER AA R D
GERARDO	JH ER AA R D OW
GERDA	G ER D AH
GERHARD	G ER HH AA R D
GERHARDT	G ER HH AA R T
GERI	JH EH R IY
GERMAINE	ZH ER M EY N
GERMAN	JH ER M AH N
GEROLD	G EH R OW L D
GERRI	JH EH R IY
GERRIT	JH EH R IH T
GERRY	JH EH R IY
GERTHA	JH AH R TH AH
GERTIE	JH ER T IY
GERTRUDE	G ER T R UW D
GIA	JH AY AH
GIADA	JH AY AH D AH
GIANA	JH AY AH N AH
GIANCARLO	JH IY AE NG K AA R L OW
GIANNA	JH AY AE N AH
GIANNI	JH AA N IY
GIANNI(2)	JH IY AA N IY
GIANNI(3)	JH Y AA N IY
GIBSON	G IH B S AH N
GIDEON	G IH D IY AH N
GIDGET	G IH JH AH T
GIFFORD	G IH F ER D
GIGI	JH IY JH IY
GIL	G IH L
GILBERT	G IH L B ER T
GILBERTO	G IH L B EH R T OW
GILBERTO(2)	G IH L B ER T OW
GILDA	G IH L D AH
GILES	JH AY L Z
GILFORD	G IH L F ER D
GILLIAN	JH IH L IY AH N
GILLIE	G IH L IY
GILMAN	G IH L M AH N
GILMER	G IH L M ER
GILMORE	G IH L M AO R
GINA	JH IY N AH
GINGER	JH IH N JH ER
GINNY	JH IH N IY
GINO	JH IY N OW
GIOVANI	JH AY AA V AH N IY
GIOVANNA	JH AY AH V AE N AH
GIOVANNI	JH IY OW V AA N IY
GIOVANNI(2)	JH AH V AA N IY
GIOVANNY	JH AY AH V AE N IY
GIRTHA	JH AH R TH AH
GISELE	JH AH S IY L
GISELLE	ZH IH S EH L
GISSELLE	JH IH S AH L
GIULIANA	JH AY AH L IY AH N AH
GIUSEPPE	JH IH S EH P IY
GLADIS	G L AE D IH S
GLADSTONE	G L AE D S T OW N
GLADYCE	G L AH D AY S
GLADYS	G L AE D IH S
GLEN	G L EH N
GLENDA	G L EH N D AH
GLENDON	G L EH N D OW N
GLENDORA	G L EH N D AH R AH
GLENN	G L EH N
GLENNA	G L EH N AH
GLENNIE	G L EH N IY
GLENNIS	G L EH N IY Z
GLENWOOD	G L EH N W UH D
GLINDA	G L IH N D AH
GLORIA	G L AO R IY AH
GLOVER	G L AH V ER
GLYNDA	G L IH N D AH
GLYNIS	G L IH N IH S
GLYNN	G L IH N
GODFREY	G AA D F R IY
GOEBEL	G OW B AH L
GOLDA	G OW L D AH
GOLDEN	G OW L D AH N
GOLDIA	G OW L D IY AH
GOLDIE	G OW L D IY
GONZALO	G AA N Z AA L OW
GORDEN	G AO R D AH N
GORDON	G AO R D AH N
GORGE	G AO R JH
GOTTLIEB	G AA T L IY B
GOVERNOR	G AH V ER N ER
GRACE	G R EY S
GRACELYN	G R AE S AH L AH N
GRACIA	G R AA CH AH
GRACIE	G R EY S IY
GRACIELA	G R EY S IY L AH
GRADY	G R EY D IY
GRAFTON	G R AE F T AH N
GRAHAM	G R EY AH M
GRAHAM(2)	G R AE M
GRANT	G R AE N T
GRANVILLE	G R AE N V IH L
GRAVES	G R EY V Z
GRAY	G R EY
GRAYCE	G R EY S
GRAYDON	G R EY D AH N
GRAYLING	G R EY L IH NG
GRAYSON	G R EY S AH N
GRECIA	G R IY SH IY AH
GREEN	G R IY N
GREENE	G R IY N
GREG	G R EH G
GREGG	G R EH G
GREGGORY	G R EH G AH R IY
GREGORIA	G R EH G AO R IY AH
GREGORIO	G R IH G AO R IY OW
GREGORY	G R EH G ER IY
GRETA	G R IY T AH
GRETCHEN	G R EH CH AH N
GRETTA	G R EH T AH
GREYSON	G R EY S AH N
GRIFFIN	G R IH F IH N
GRIFFITH	G R IH F AH TH
GRIFFITH(2)	G R IH F IH TH
GRISEL	G R IH S AH L
GRISELDA	G R AH S EH L D AH
GROVE	G R OW V
GROVER	G R OW V ER
GUADALUPE	G W AA D AH L UW P
GUADALUPE(2)	G W AA D AH L UW P EY
GUIDO	G W IY D OW
GUILFORD	G IH L F ER D
GUILLERMO	G W IH L Y EH R M OW
GUILLERMO(2)	G IY EH R M OW
GUILLERMO(3)	G W IY EH R M OW
GUNDA	G AH N D AH
GUNNAR	G AH N ER
GUNNER	G AH N ER
GURNEY	G ER N IY
GUS	G AH S
GUSS	G AH S
GUSSIE	G AH S IY
GUST	G AH S T
GUSTA	G AH S T AH
GUSTAF	G UW S T AA F
GUSTAV	G UH S T AA F
GUSTAVE	G UW S T AA V IY
GUSTAVO	G AH S T AA V OW
GUSTAVUS	G AH S T AH V AH S
GUSTIE	G AH S T IY
GUTHRIE	G AH TH R IY
GUY	G AY
GWEN	G W EH N
GWENDA	G W EH N D AH
GWENDOLYN	G W EH N D AH L IH N
GWYN	G W IH N
GWYNETH	G W IH N AH TH
HADASSAH	HH AH D AE S AH
HADEN	HH EY D AH N
HADLEY	HH AE D L IY
HAIDEN	HH EY D AH N
HAILEE	HH EY L IY
HAILEY	HH EY L IY
HAILIE	HH EY L IY
HAKEEM	HH AA K IY M
HAKIM	HH AA K IY M
HAKIM(2)	AA K IY M
HAL	HH AE L
HALBERT	HH AE L B ER T
HALE	HH EY L
HALEIGH	HH EY L EY
HALEY	HH EY L IY
HALI	HH AE L IY
HALIE	HH EY L IY
HALL	HH AO L
HALLE	HH AE L
HALLE(2)	HH AE L IY
HALLEY	HH AE L IY
HALLEY(2)	HH EY L IY
HALLIE	HH AO L IY
HALSEY	HH AE L S IY
HAM	HH AE M
HAMILTON	HH AE M AH L T AH N
HAMP	HH AE M P
HAMPTON	HH AE M P T AH N
HAMZA	HH AE M Z AH
HANA	HH AE N AH
HANDY	HH AE N D IY
HANK	HH AE NG K
HANNA	HH AE N AH
HANNAH	HH AE N AH
HANS	HH AA N S
HANS(2)	HH AE N Z
HANSEL	HH AE N S AH L
HANSFORD	HH AE N S F ER D
HANSON	HH AE N S AH N
HARDEN	HH AA R D AH N
HARDIE	HH AA R D IY
HARDIN	HH AA R D IH N
HARDING	HH AA R D IH NG
HARDY	HH AA R D IY
HARL	HH AA R L
HARLAN	HH AA R L AH N
HARLAND	HH AA R L AH N D
HARLEN	HH AA R L AH N
HARLENE	HH AA R L IY N
HARLEY	HH AA R L IY
HARLIE	HH AA R L AY
HARLON	HH AA R L AH N
HARLOW	HH AA R L OW
HARM	HH AA R M
HARMAN	HH AA R M AH N
HARMON	HH AA R M AH N
HARMONY	HH AA R M AH N IY
HAROLD	HH EH R AH L D
HARPER	HH AA R P ER
HARRELL	HH EH R AH L
HARRIE	HH AE R AY
HARRIET	HH EH R IY AH T
HARRIETT	HH AE R IY T
HARRIETTE	HH AE R IY EH T
HARRIS	HH EH R IH S
HARRISON	HH EH R IH S AH N
HARROLD	HH EH R AH L D
HARRY	HH EH R IY
HART	HH AA R T
HARTLEY	HH AA R T L IY
HARTWELL	HH AA R T W EH L
HARUKO	HH AH R UW K OW
HARVE	HH AA R V
HARVEY	HH AA R V IY
HARVIE	HH AA R V IY
HARVY	HH AA R V IY
HASAN	HH AA S AA N
HASEL	HH AE S AH L
HASKELL	HH AE S K AH L
HASSAN	HH AH S AA N
HASSIE	HH AE Z IY
HATTIE	HH AE T IY
HAVEN	HH EY V AH N
HAYDEN	HH EY D AH N
HAYES	HH EY Z
HAYLEE	HH EY L IY
HAYLEIGH	HH EY L EY
HAYLEY	HH EY L IY
HAYLIE	HH EY L AY
HAYS	HH EY Z
HAYWARD	HH EY W ER D
HAYWOOD	HH EY W UH D
HAZEL	HH EY Z AH L
HAZELLE	HH AE Z AH L
HAZEN	HH EY Z AH N
HAZLE	HH EY Z AH L
HEATH	HH IY TH
HEATHER	HH EH DH ER
HEAVEN	HH EH V AH N
HEBER	HH IY B ER
HEBERT	HH EH B ER T
HECTOR	HH EH K T ER
HEDWIG	HH EH D W IH G
HEDY	HH IY D IY
HEIDI	HH AY D IY
HEIDY	HH IY D IY
HELAINE	HH AH L EY N
HELEN	HH EH L AH N
HELENA	HH EH L AH N AH
HELENE	HH AH L IY N
HELGA	HH EH L G AH
HELLEN	HH EH L AH N
HELMA	HH EH L M AH
HELMER	HH EH L M ER
HELYN	HH EH L AH N
HENCE	HH EH N S
HENDERSON	HH EH N D ER S AH N
HENERY	HH EH N ER IY
HENNIE	HH EH N IY
HENRETTA	HH EH N R EH T AH
HENRI	HH EH N R IY
HENRI(2)	AO R IY
HENRI(3)	AA N R IY
HENRIETTA	HH EH N R IY EH T AH
HENRIETTE	HH EH N R IY EH T
HENRY	HH EH N R IY
HERB	ER B
HERB(2)	HH ER B
HERBERT	HH ER B ER T
HERIBERTO	HH EH R AH B AH R T OW
HERLINDA	HH AH R L IH N D AH
HERMA	HH AH R M AH
HERMAN	HH ER M AH N
HERMANN	HH ER M AH N
HERMINA	HH ER M IH N AH
HERMINA(2)	HH ER M IY N AH
HERMINE	HH ER M IH N
HERMINIA	HH EH R M IY N IY AH
HERMON	HH ER M AH N
HERNAN	HH ER N AH N
HERSCHEL	HH ER SH AH L
HERSHEL	HH AH R SH AH L
HERSHELL	HH ER Z HH EH L
HERTHA	HH ER TH AH
HERVEY	HH ER V EY
HESSIE	HH IY Z IY
HESTER	HH EH S T ER
HETTIE	HH EH T IY
HETTY	HH EH T IY
HEYWARD	HH EY W ER D
HEZEKIAH	HH AH Z IY K AY AH
HEZZIE	HH EH Z AY
HIDEO	HH IH D EY OW
HILAH	HH IH L AH
HILARIO	HH IY L AA R IY OW
HILARY	HH IH L ER IY
HILBERT	HH IH L B ER T
HILDA	HH IH L D AH
HILDEGARD	HH IH L D AH G AA R D
HILDEGARDE	HH IH L D IH G AA R D
HILDRED	HH IH L D AH R D
HILDUR	HH IH L D AH R
HILL	HH IH L
HILLARD	HH IH L ER D
HILLARY	HH IH L ER IY
HILLERY	HH IH L ER IY
HILLIARD	HH IH L Y AA R D
HILMA	HH IH L M AH
HILMER	HH IH L M ER
HILTON	HH IH L T AH N
HIRAM	HH AY R AH M
HIROSHI	HH IH R OW SH IY
HJALMAR	HH JH AE M AH R
HJALMER	HH JH AE M AH R
HOBART	HH OW B AA R T
HOBERT	HH AA B ER T
HOBSON	HH AA B S AH N
HOKE	HH OW K
HOLDEN	HH OW L D AH N
HOLLAND	HH AA L AH N D
HOLLI	HH AA L IY
HOLLIE	HH AA L IY
HOLLIS	HH AA L IH S
HOLLY	HH AA L IY
HOLMES	HH OW M Z
HOLMES(2)	HH OW L M Z
HOMER	HH OW M ER
HONORA	AO N AO R AH
HOOVER	HH UW V ER
HOPE	HH OW P
HORACE	HH AO R AH S
HORACE(2)	HH AO R IH S
HORACIO	HH AO R EY S IY OW
HORATIO	HH ER EY SH OW
HORTENCIA	HH AO R T EH N CH IY AH
HORTENSE	HH AO R T AH N S
HORTENSIA	HH AO R T EH N CH IY AH
HORTON	HH AO R T AH N
HOSEA	HH OW S IY AH
HOSEA(2)	HH OW Z EY AH
HOSIE	HH OW Z IY
HOSTEEN	HH OW S T IY AH N
HOUSTON	HH Y UW S T AH N
HOWARD	HH AW ER D
HOWELL	HH AW AH L
HOY	HH OY
HOYT	HH OY T
HUBBARD	HH AH B ER D
HUBERT	HH Y UW B ER T
HUDSON	HH AH D S AH N
HUEY	HH Y UW IY
HUGH	HH Y UW
HUGH(2)	Y UW
HUGHES	HH Y UW Z
HUGHES(2)	Y UW Z
HUGHEY	HH AH G IY
HUGHEY(2)	HH Y UW IY
HUGHEY(3)	Y UW IY
HUGHIE	HH Y UW IY
HUGHIE(2)	Y UW IY
HUGO	HH Y UW G OW
HUGO(2)	Y UW G OW
HULDA	HH AH L D AH
HULDAH	HH AH L D AH
HUMBERTO	HH AH M B ER T OW
HUMBERTO(2)	UW M B EH R T OW
HUMPHREY	HH AH M F R IY
HUNG	HH AH NG
HUNT	HH AH N T
HUNTER	HH AH N T ER
HURBERT	HH AH R B AH R T
HURLEY	HH ER L IY
HUSTON	HH AH S T AH N
HUY	HH Y UW IY
HYMAN	HH AY M AH N
HYMEN	HH AY M AH N
HYRUM	HH IH R AH M
IAN	IY AH N
IBRAHIM	IH B R AA HH IY M
ICA	IH K AH
ICEY	AY S IY
ICIE	AY S IY
ICY	AY S IY
IDA	AY D AH
IDABELLE	IH D AH B AH L
IDAMAE	IH D AH M IY
IDELL	IH D AH L
IDELLA	AH D EH L AH
IESHA	IY SH AH
IESHIA	IY SH IY AH
IGNACIO	IH G N AA S IY OW
IGNATIUS	IH G N EY SH AH S
IGNATZ	IH G N AH T S
IKE	AY K
ILA	IY L AH
ILAH	IH L AH
ILDA	IH L D AH
ILENE	IH L IY N
ILIANA	AH L IY AH N AH
ILLA	IH L AH
ILLYA	IH L AY AH
ILMA	IH L M AH
ILO	AY L OW
ILONA	IH L OW N AH
IMA	AH M AA
IMANI	AH M AE N IY
IMANOL	AH M AE N AH L
IMELDA	IH M EH L D AH
IMMANUEL	IH M AH N UH L
IMO	AY M OW
IMO(2)	AY EH M OW
IMOGENE	IH M AH JH IY N
INA	IY N AH
INDIA	IH N D IY AH
INDIANA	IH N D IY AE N AH
INELL	AH N EH L
INES	IH N IH S
INES(2)	IH N EH S
INEZ	IH N EH Z
INFANT	IH N F AH N T
INGA	IY NG G AH
INGEBORG	IH N JH EH B AH R G
INGER	IH NG ER
INGRAM	IH NG G R AH M
INGRID	IH NG G R IH D
IOLA	AY OW L AH
IONA	AY OW N AH
IONE	AY OW N IY
IRA	AY R AH
IRA(2)	AY AA R EY
IRELAND	AY ER L AH N D
IRELAND(2)	AY R L AH N D
IRENA	IH R EY N AH
IRENE	AY R IY N
IRIDIAN	AH R IH D IY AH N
IRINE	AH R AY N
IRIS	AY R AH S
IRIS(2)	AY R IH S
IRL	AH R L
IRMA	ER M AH
IRVA	AH R V AH
IRVEN	AH R V AH N
IRVIN	ER V IH N
IRVINE	ER V AY N
IRVING	ER V IH NG
IRWIN	ER W AH N
IRWIN(2)	ER W IH N
ISA	IY S AH
ISAAC	AY Z AH K
ISAAC(2)	AY Z IH K
ISAAK	IH S AA K
ISAAK(2)	AY Z AE K
ISABEL	IH Z AH B EH L
ISABELA	AH S AE B AH L AH
ISABELL	IH S AA B EH L
ISABELLA	IH Z AH B EH L AH
ISABELLE	IH Z AH B EH L
ISADORA	AH S AE D AH R AH
ISADORE	IH S AA D AO R EY
ISADORE(2)	IH S AA D AO R
ISAI	IH S EY
ISAIAH	AY Z EY AH
ISAIAS	IH S EY AH Z
ISAM	IH S AH M
ISAMAR	AY Z AH M AA R
ISHAAN	IH SH EY AH N
ISHAM	IH SH AH M
ISHMAEL	IH SH M IY L
ISHMAEL(2)	IH SH M EY L
ISIAH	IH S AY AH
ISIDOR	AY Z AH D ER
ISIDORE	IH Z IH D AO R
ISIDRO	AH S IH D R OW
ISIS	AY S AH S
ISLA	IY L AH
ISMAEL	IH S M EY L
ISOBEL	AY S AO B EH L
ISOM	AY S AH M
ISRAEL	IH Z R IY AH L
ISRAEL(2)	IH Z R EY L
ISREAL	AY Z R IY L
ISSAC	IH S AH K
ISSAC(2)	AY Z IH K
ITZEL	IH T S AH L
IVA	IY V AH
IVAH	IH V AH
IVAN	AY V AH N
IVANA	IH V AA N AH
IVER	AY V ER
IVERSON	AY V ER S AH N
IVETTE	AY V EH T
IVEY	AY V IY
IVIE	AY V IY
IVONNE	IH V AH N
IVOR	AY V ER
IVORY	AY V ER IY
IVORY(2)	AY V R IY
IVY	AY V IY
IYANA	AY AY AH N AH
IYANNA	AY AY AE N AH
IZA	IH Z AH
IZABELLA	IH Z AH B EH L AH
IZABELLE	IH Z AH B AH L
IZAIAH	IH Z EY AH
IZAYAH	IH Z EY AH
IZETTA	AH Z EH T AH
IZOLA	IH Z AH L AH
IZORA	IH Z AH R AH
JABARI	JH AE B AH R IY
JABBAR	JH AH B AA R
JABEZ	JH AE B AH Z
JACALYN	JH AE K AH L AH N
JACE	JH EY S
JACEY	JH EY S IY
JACK	JH AE K
JACKELINE	JH AE K AH L AY N
JACKI	JH AE K IY
JACKIE	JH AE K IY
JACKLYN	JH AE K L IH N
JACKSON	JH AE K S AH N
JACKY	JH AE K IY
JACLYN	JH AE K L IH N
JACOB	JH EY K AH B
JACOBY	JH AH K OW B IY
JACQUE	ZH EY K
JACQUELIN	JH AE K W AH L AH N
JACQUELINE	JH AE K W AH L IH N
JACQUELINE(2)	JH AE K L IH N
JACQUELINE(3)	JH AE K AH L IH N
JACQUELYN	JH AE K W IH L IH N
JACQUELYNN	JH AE K W AH L AH N
JACQUES	ZH AA K
JACQUES(2)	JH AE K
JACQUEZ	Y AA K W EH Z
JACQULINE	JH AE K W L AY N
JACQULYN	JH AE K W L AH N
JADA	JH AE D AH
JADE	JH EY D
JADEN	JH EY D AH N
JADIEL	JH EY D IY L
JADON	JH AE D AH N
JADYN	JH AE D AH N
JAEDA	JH IY D AH
JAEDEN	JH IY D AH N
JAELYN	JH IY L AH N
JAELYNN	JH IY L AH N
JAGGER	JH AE G ER
JAHEEM	JH AH HH IY M
JAHEIM	JH AH HH IY M
JAHIEM	JH AH HH IY M
JAHIR	JH AE HH AH R
JAIDA	JH EY D AH
JAIDEN	JH EY D AH N
JAIDYN	JH EY D AH N
JAILENE	JH EY L IY N
JAILYN	JH EY L AH N
JAIME	HH AY M IY
JAIMEE	JH EY M IY IY
JAIMIE	JH EY M IY
JAIMIE(2)	HH AY M IY
JAIR	JH AE AH R
JAIRO	JH AE AH R OW
JAJUAN	JH AH JH UW W AH N
JAKAYLA	JH AH K EY L AH
JAKE	JH EY K
JAKOB	JH AE K AH B
JAKOBE	JH AH K OW B
JALEEL	JH EY L IY L
JALEESA	JH EY L IY S AH
JALEN	JH EY L AH N
JALISA	JH AE L AH S AH
JALISSA	JH AH L IH S AH
JALIYAH	JH EY L IY AY AH
JALON	JH AE L AH N
JALYN	JH AE L AH N
JALYNN	JH AE L AH N
JAMAAL	JH AE M EY AH L
JAMAL	JH AH M AA L
JAMAR	Y AA M AA R
JAMARCUS	JH AH M AA R K AH S
JAMARI	JH AE M AH R IY
JAMARION	JH AE M ER IY AH N
JAME	JH EY M
JAMEEL	JH AE M IY L
JAMEL	JH AE M AH L
JAMES	JH EY M Z
JAMESON	JH EY M S AH N
JAMEY	JH EY M IY
JAMI	JH EY M IY
JAMIE	JH EY M IY
JAMIL	JH AE M AH L
JAMILA	JH AH M IH L AH
JAMIN	JH AE M IH N
JAMIR	JH AE M AH R
JAMISON	JH EY M IH S AH N
JAMIYA	JH EY M IY AY AH
JAMMIE	JH AE M IY
JAMYA	JH AE M AY AH
JAN	JH AE N
JANA	JH AE N AH
JANAE	JH AE N IY
JANAY	JH AE N EY IY
JANE	JH EY N
JANEEN	JH EY N IY AH N
JANEL	JH AE N AH L
JANELL	JH AE N AH L
JANELLE	ZH AH N EH L
JANENE	JH AH N IY N
JANESSA	JH AH N EH S AH
JANET	JH AE N AH T
JANET(2)	JH AE N IH T
JANETTE	JH AH N EH T
JANEY	JH EY N IY
JANIAH	JH EY N AY AH
JANICE	JH AE N AH S
JANICE(2)	JH AE N IH S
JANIE	JH EY N IY
JANINE	JH AH N IY N
JANIS	JH AE N IH S
JANIYA	JH EY N IY AY AH
JANIYAH	JH EY N IY AY AH
JANN	JH AE N
JANNA	JH AE N AH
JANNETTE	JH AE N EH T
JANNIE	JH AE N AY
JANUARY	JH AE N Y UW EH R IY
JANYCE	JH AH N AY S
JAQUAN	JH AE K W AH N
JAQUELIN	JH AE K W AH L AH N
JAQUELINE	JH AE K W AH L AY N
JAQUEZ	Y AA K W EH Z
JARAD	JH AE R AH D
JARED	JH EH R IH D
JAREN	JH AA R AH N
JARET	JH AE R AH T
JARETT	JH AE R AH T
JAROD	JH AE R AH D
JARON	JH AA R AO N
JARRAD	JH AE R AH D
JARRED	JH AA R D
JARRELL	Y AA R EY L
JARRET	JH AE R AH T
JARRETT	JH EH R AH T
JARROD	JH AE R AH
JARVIS	JH AA R V AH S
JARVIS(2)	JH AA R V IH S
JASE	JH EY Z
JASEN	JH EY Z AH N
JASIAH	JH EY S AY AH
JASLENE	JH AE Z L IY N
JASLYN	JH AE Z L AH N
JASMIN	JH AE Z M IH N
JASMINE	JH AE Z M AH N
JASMINE(2)	JH AE Z M IH N
JASMYN	JH AE Z M AH N
JASMYNE	JH AE Z M AY N
JASON	JH EY S AH N
JASPER	JH AE S P ER
JAUNITA	JH AO N AH T AH
JAVEN	JH EY V AH N
JAVIER	HH AA V IY EH R
JAVION	JH EY V IY AH N
JAVON	JH AE V AH N
JAVONTE	JH AE V AH N T
JAX	JH AE K S
JAXON	JH AE K S AH N
JAXSON	JH AE K S AH N
JAY	JH EY
JAYCE	JH EY S
JAYCEE	JH EY S IY
JAYCIE	JH EY S AY
JAYDA	JH EY D AH
JAYDAN	JH EY D AH N
JAYDE	JH EY D
JAYDEN	JH EY D AH N
JAYDIN	JH EY D IH N
JAYDON	JH EY D AA N
JAYE	JH EY
JAYLA	JH EY L AH
JAYLAH	JH EY L AH
JAYLAN	JH EY L AH N
JAYLEE	JH EY L IY
JAYLEEN	JH EY L IY AH N
JAYLEN	JH EY L AH N
JAYLENE	JH EY L IY N
JAYLIN	JH EY L AH N
JAYLON	JH EY L AH N
JAYLYN	JH EY L AH N
JAYLYNN	JH EY L AH N
JAYME	JH EY M IY
JAYMES	JH EY M IY Z
JAYNE	JH EY N
JAYSON	JH EY Z AH N
JAYVION	JH EY V IY AH N
JAYVON	JH EY V AH N
JAZLENE	JH AE Z L IY N
JAZLYN	JH AE Z L AH N
JAZLYNN	JH AE Z L AH N
JAZMIN	JH AE Z M IH N
JAZMINE	JH AE Z M AY N
JAZMYN	JH AE Z M AH N
JAZMYNE	JH AE Z M AY N
JEAN	JH IY N
JEANA	JH IY N AH
JEANE	JH IY N
JEANETTA	JH IY N EH T AH
JEANETTE	JH AH N EH T
JEANIE	JH IY N IY
JEANINE	JH AH N IY N
JEANMARIE	JH IY N M EH R IY
JEANNA	JH IY N AH
JEANNE	JH IY N
JEANNETTE	JH AH N EH T
JEANNIE	JH IY N IY
JEANNINE	JH IY N AY N
JEB	JH EH B
JED	JH EH D
JEDEDIAH	JH AH D IY D AY AH
JEDIDIAH	JH AH D IH D AY AH
JEFF	JH EH F
JEFFEREY	JH EH F ER IY
JEFFERSON	JH EH F ER S AH N
JEFFERY	JH EH F ER IY
JEFFIE	JH EH F AY
JEFFREY	JH EH F R IY
JEFFRY	JH EH F R IY
JELANI	JH EH L AH N IY
JEMAL	JH IY M AH L
JEMIMA	JH EH M IY M AH
JENA	JH IY N AH
JENELLE	JH EH N AH L
JENIFER	JH AH N AY F AH R
JENILEE	JH IY N AH L IY IY
JENNA	JH EH N AH
JENNETTE	ZH IH N EH T
JENNI	JH EH N IY
JENNIE	JH EH N IY
JENNIFER	JH EH N AH F ER
JENNIFFER	JH EH N IH F AH R
JENNINGS	JH EH N IH NG Z
JENNY	JH EH N IY
JENS	JH EH N Z
JENSEN	JH EH N S AH N
JEP	JH EH P
JEPTHA	JH EH P TH AH
JERAD	JH EH R AH D
JERALD	JH EH R AH L D
JERALDINE	JH EH R AH L D AY N
JERAMIAH	JH AH R EY M AY AH
JERAMIE	JH AH R EY M AY
JERAMY	JH EH R AH M IY
JERE	JH EH R IY
JERED	JH IY R D
JEREL	JH EH R AH L
JEREME	JH AH R IY M
JEREMEY	JH AH R IY M IY
JEREMIAH	JH EH R AH M AY AH
JEREMIE	JH AH R IY M AY
JEREMY	JH EH R AH M IY
JERI	JH EH R IY
JERICA	JH EH R AH K AH
JERILYN	JH EH R AH L AH N
JERILYNN	JH EH R AH L AH N
JERIMIAH	JH AH R IH M AY AH
JERIMY	JH EH R AH M IY
JERMAIN	JH AH R M EY N
JERMAINE	JH ER M EY N
JERMEY	JH AH R M IY
JEROD	JH EH R AH D
JEROLD	JH EH R OW L D
JEROME	JH ER OW M
JEROMY	JH EH R AH M IY
JERRAD	JH EH R AH D
JERREL	JH EH R AH L
JERRELL	Y EH R EY L
JERRELL(2)	JH EH R AH L
JERRI	JH EH R IY
JERRICA	JH EH R AH K AH
JERRIE	JH EH R IY
JERRILYN	JH EH R AH L AH N
JERROD	JH EH R AH D
JERROLD	JH EH R AH L D
JERRY	JH EH R IY
JERUSHA	JH EH R AH SH AH
JERYL	JH EH R AH L
JESENIA	JH AH S IY N Y AH
JESICA	JH EH S AH K AH
JESS	JH EH S
JESSE	JH EH S IY
JESSEE	JH EH S IY
JESSENIA	JH EH S IY N Y AH
JESSI	JH EH S IY
JESSICA	JH EH S IH K AH
JESSIE	JH EH S IY
JESSIKA	JH EH S AH K AH
JESSY	JH EH S IY
JESSYE	JH EH S IY
JESUS	JH IY Z AH S
JETHRO	JH EH TH R OW
JETT	JH EH T
JETTA	JH EH T AH
JETTIE	JH EH T IY
JEVON	JH EH V AH N
JEWEL	JH UW AH L
JEWEL(2)	JH UW L
JEWELL	JH UW IH L
JILES	JH AY L Z
JILL	JH IH L
JILLIAN	JH IH L IY AH N
JILLIAN(2)	JH IH L Y AH N
JIM	JH IH M
JIMENA	JH IH M AH N AH
JIMMIE	JH IH M IY
JIMMY	JH IH M IY
JINNIE	JH IH N AY
JO	JH OW
JOAN	JH OW N
JOANA	JH OW N AH
JOANIE	JH OW N IY
JOANN	JH OW AE N
JOANNA	JH OW AE N AH
JOANNE	JH OW AE N
JOAQUIN	W AA K IY N
JOB	JH AA B
JOB(2)	JH OW B
JOBE	JH OW B
JOCELYN	JH AO S L IH N
JOCELYNE	JH AO S L IH N
JOCELYNN	JH AA S AH L AH N
JODI	JH OW D IY
JODIE	JH OW D IY
JODY	JH OW D IY
JOE	JH OW
JOEL	JH OW AH L
JOELL	JH OW AH L
JOELLA	JH OW EH L AH
JOELLE	JH OW EH L
JOELLEN	JH OW EH L AH N
JOESEPH	JH OW AH S AH F
JOESPH	JH OW AH S
JOETTA	JH OW EH T AH
JOETTE	ZH OW EH T
JOETTE(2)	JH OW EH T
JOEY	JH OW IY
JOHAN	Y OW HH AA N
JOHANA	JH AA HH AH N AH
JOHANNA	JH AH HH AE N AH
JOHANNAH	JH AH HH AE N AH
JOHATHAN	JH AA HH AH TH AH N
JOHN	JH AA N
JOHNATHAN	JH AA N AH TH AH N
JOHNATHON	JH AA N AH TH AH N
JOHNEY	JH AA N IY
JOHNIE	JH AA N IY
JOHNNA	JH AA N AH
JOHNNIE	JH AA N IY
JOHNNY	JH AA N IY
JOHNPAUL	JH AA N P AH L
JOHNSON	JH AA N S AH N
JOHNY	JH AA N IY
JOI	JH OY
JOLEEN	JH OW L IY AH N
JOLENE	JH OW L IY N
JOLETTE	JH OW L EH T
JOLIE	JH OW L IY
JOLINE	JH AH L AY N
JON	JH AA N
JONAH	JH OW N AH
JONAS	JH OW N AH S
JONATAN	JH OW N EY T AH N
JONATHAN	JH AA N AH TH AH N
JONATHON	JH AA N AH TH AH N
JONELL	JH AA N AH L
JONES	JH OW N Z
JONI	JH OW N IY
JONNA	JH AA N AH
JONNIE	JH AA N AY
JORDAN	JH AO R D AH N
JORDEN	JH AO R D AH N
JORDI	JH AO R D IY
JORDIN	JH AO R D AH N
JORDON	JH AO R D AH N
JORDY	JH AO R D IY
JORDYN	JH AO R D AH N
JORETTA	JH AH R EH T AH
JORGE	HH AO R HH EY
JORJA	JH AO R JH AH
JORY	JH AO R IY
JOSE	HH OW Z EY
JOSEF	JH OW S AH F
JOSEFA	JH AA S AH F AH
JOSEFINA	Y OW S IH F IY N AH
JOSEFINA(2)	JH OW Z AH F IY N AH
JOSEFITA	JH AH S EH F AH T AH
JOSELIN	JH AA S AH L AH N
JOSELINE	JH AA S AH L AY N
JOSELUIS	JH AA S AH L UW W AH S
JOSELYN	JH AA S AH L AH N
JOSEPH	JH OW S AH F
JOSEPH(2)	JH OW Z AH F
JOSEPHINE	JH OW S AH F IY N
JOSEPHUS	JH OW S IY F AH S
JOSETTE	ZH AH S EH T
JOSH	JH AA SH
JOSHUA	JH AA SH UW AH
JOSHUAH	JH AH SH UW W AH
JOSIAH	JH OW S AY AH
JOSIE	JH OW Z IY
JOSIEPHINE	JH OW S AH F AY N
JOSLYN	JH AO S L IH N
JOSSIE	JH OW Z IY
JOSUE	JH AA S UW
JOURNEY	JH ER N IY
JOVAN	JH OW V AH N
JOVANI	JH AA V AH N IY
JOVANNI	JH AH V AE N IY
JOVANNY	JH AH V AE N IY
JOVANY	JH AA V AH N IY
JOVITA	Y AH V AY T AH
JOY	JH OY
JOYCE	JH OY S
JOYCELYN	JH OY S L IH N
JOYE	JH OY
JUAN	W AA N
JUAN(2)	HH W AA N
JUANA	W AA N AH
JUANA(2)	HH W AA N AH
JUANITA	W AA N IY T AH
JUANITA(2)	JH UW AH N IY T AH
JUDAH	JH UW D AH
JUDD	JH AH D
JUDE	JH UW D
JUDGE	JH AH JH
JUDI	JH UW D IY
JUDIE	JH AH D IY
JUDITH	JH UW D IH TH
JUDSON	JH AH D S AH N
JUDY	JH UW D IY
JUDYTH	JH UW D AH TH
JULE	JH UW L
JULES	JH UW L Z
JULI	JH UW L IY
JULIA	JH UW L Y AH
JULIAN	JH UW L IY AH N
JULIAN(2)	JH UW L Y AH N
JULIANA	JH UW L IY AE N AH
JULIANN	JH UW L IY AE N
JULIANN(2)	JH UW L Y AH N
JULIANNA	JH UW L IY AE N AH
JULIANNE	JH UW L IY EH N
JULIE	JH UW L IY
JULIEN	JH UW L IY AH N
JULIET	JH UW L IY EH T
JULIETTE	JH UW L IY EH T
JULIO	JH UW L IY OW
JULIO(2)	HH UW L IY OW
JULIOUS	JH UW L IY AH S
JULISA	JH UW L AH S AH
JULISSA	JH UW L IH S AH
JULIUS	JH UW L Y AH S
JULUIS	JH UW L UW W AH S
JUNE	JH UW N
JUNIA	Y UW N IY AH
JUNIE	JH UW N AY
JUNIOR	JH UW N Y ER
JUNIOUS	JH UW N IY AH S
JUNIUS	JH UW N IY IH S
JUSTEN	JH AH S T AH N
JUSTICE	JH AH S T AH S
JUSTICE(2)	JH AH S T IH S
JUSTIN	JH AH S T AH N
JUSTIN(2)	JH AH S T IH N
JUSTINA	Y UW S T IY N AH
JUSTINE	JH AH S T IY N
JUSTON	JH AH S T AO N
JUSTUS	JH AH S T AH S
JUSTYN	JH AH S T AH N
JUWAN	JH UW AA N
KAAREN	K AA R AH N
KACEY	K EY S IY
KACI	K AE S IY
KACIE	K EY S AY
KACY	K EY S IY
KADE	K EY D
KADEEM	K EY D IY M
KADEN	K EY D AH N
KADENCE	K EY D AH N S
KADIJAH	K AE D AH JH AH
KADIN	K AE D AH N
KADYN	K AE D AH N
KAEDEN	K IY D AH N
KAEL	K EY L
KAELA	K IY L AH
KAELYN	K IY L AH N
KAHLIL	K AE L AH L
KAI	K AY
KAIA	K EY AH
KAIDEN	K EY D AH N
KAILA	K EY L AH
KAILEE	K EY AH L IY IY
KAILEY	K EY AH L IY
KAILYN	K EY L AH N
KAITLIN	K EY T L AH N
KAITLYN	K EY T L AH N
KAITLYNN	K EY T L AH N
KAIYA	K EY AY AH
KALA	K AE L AH
KALE	K EY L
KALEB	K AE L AH B
KALEENA	K EY L IY N AH
KALEIGH	K EY L EY
KALEN	K EY L AH N
KALENE	K AH L IY N
KALEY	K EY L IY
KALI	K AE L IY
KALIE	K EY L IY
KALIYAH	K EY L IY AY AH
KALLIE	K AE L AY
KALVIN	K AE L V AH N
KALYN	K AE L AH N
KAMARI	K AE M AH R IY
KAMDEN	K AE M D AH N
KAMERON	K AE M AH R AH N
KAMI	K AE M IY
KAMILA	K AE M AH L AH
KAMILAH	K AE M AH L AH
KAMORA	K AE M AH R AH
KAMREN	K AE M R AH N
KAMRON	K AE M R AH N
KAMRYN	K AE M R AH N
KANDACE	K AE N D AH S
KANDI	K AE N D IY
KANDICE	K AE N D AH S
KANDY	K AE N D IY
KANE	K EY N
KANESHA	K AE N AH SH AH
KANISHA	K AE N AH SH AH
KANYE	K AE N AY
KARA	K EH R AH
KARAN	K EH R AH N
KAREEM	K ER IY M
KAREEN	K AE R IY AH N
KAREL	K EH R AH L
KAREN	K EH R AH N
KARI	K EH R IY
KARIE	K AE R AY
KARIM	K ER IY M
KARIN	K EH R IH N
KARINA	K AE R AH N AH
KARIS	K EH R IY Z
KARISSA	K AH R IH S AH
KARL	K AA R L
KARLA	K AA R L AH
KARLEE	K AA R L IY IY
KARLENE	K AA R L IY N
KARLEY	K AA R L IY
KARLI	K AA R L IY
KARLIE	K AA R L AY
KARLY	K AA R L IY
KARMA	K AA R M AH
KAROL	K EH R AO L
KAROLYN	K AE R AH L IH N
KARON	K EH R AH N
KARREN	K AE R AH N
KARRI	K AE R IY
KARRIE	K AE R AY
KARSON	K AA R S AH N
KARSYN	K AA R S AH N
KARTER	K AA R T ER
KARYL	K AE R AH L
KARYME	K AH R AY M
KARYN	K AE R IH N
KASANDRA	K AH S AE N D R AH
KASEN	K EY Z AH N
KASEY	K AE S IY
KASH	K AE SH
KASIE	K EY S AY
KASON	K AE S AH N
KASSANDRA	K AE S AE N D R AH
KASSIDY	K AE S AH D IY
KASSIE	K AE S AY
KATARINA	K AA T ER IY N AH
KATE	K EY T
KATELIN	K AE T AH L AH N
KATELYN	K AE T AH L AH N
KATELYNN	K AE T AH L AH N
KATERINA	K AH T EH R AH N AH
KATHALEEN	K AH TH EY L IY AH N
KATHARINA	K AE TH EH R IY N AH
KATHARINE	K AE TH R IH N
KATHARYN	K AE TH AH R AH N
KATHERIN	K AE TH AH R AH N
KATHERINE	K AE TH ER IH N
KATHERINE(2)	K AE TH R IH N
KATHERN	K AE TH AH R N
KATHERYN	K AE TH AH R AH N
KATHEY	K AE TH IY
KATHI	K AE TH IY
KATHIE	K AE TH IY
KATHLEEN	K AE TH L IY N
KATHLENE	K AE TH L IY N
KATHLYN	K AE TH L AH N
KATHRINE	K AE TH R AY N
KATHRYN	K AE TH R IH N
KATHRYNE	K AE TH R AY N
KATHY	K AE TH IY
KATHYRN	K AE TH AH R N
KATI	K EY T IY
KATIA	K AA T IY AH
KATIE	K EY T IY
KATINA	K AE T AH N AH
KATLIN	K AE T L AH N
KATLYN	K AE T L AH N
KATLYNN	K AE T L AH N
KATRINA	K AH T R IY N AH
KATTIE	K AE T AY
KATY	K EY T IY
KAVON	K AE V AH N
KAY	K EY
KAYA	K AA Y AH
KAYCEE	K EY S IY IY
KAYDEN	K EY D AH N
KAYDENCE	K EY D AH N S
KAYE	K EY
KAYLA	K EY L AH
KAYLAH	K EY L AH
KAYLAN	K EY L AH N
KAYLEE	K EY L IY IY
KAYLEIGH	K EY L EY
KAYLEN	K EY L AH N
KAYLENE	K EY L IY N
KAYLEY	K EY L IY
KAYLI	K EY L IY
KAYLIE	K EY L IY
KAYLIN	K EY L AH N
KAYLYN	K EY L AH N
KAYLYNN	K EY L IH N
KAZUKO	K AH Z UW K OW
KAZUO	K AA Z UW OW
KEAGAN	K IY G AH N
KEANDRE	K IY N D AH R
KEANNA	K IY N AH
KEANU	K IY AA N UW
KEANU(2)	K EY AA N UW
KEARA	K IY R AH
KEATON	K IY T AH N
KECIA	K IY SH IY AH
KEEGAN	K IY G AH N
KEELEY	K IY L IY
KEELY	K IY L IY
KEENA	K IY N AH
KEENAN	K IY N AH N
KEENEN	K IY N AH N
KEESHA	K IY SH AH
KEGAN	K IY G AH N
KEIFER	K IY F ER
KEILA	K IY L AH
KEION	K IY IY AH N
KEIRA	K IY R AH
KEISHA	K IY SH AH
KEITH	K IY TH
KELAN	K IY L AH N
KELBY	K EH L B IY
KELCIE	K EH L S AY
KELI	K EH L IY
KELIS	K IY L AH S
KELLAN	K EH L AH N
KELLEE	K EH L IY IY
KELLEN	K EH L AH N
KELLEY	K EH L IY
KELLEY(2)	OW K EH L IY
KELLI	K EH L IY
KELLIE	K EH L IY
KELLY	K EH L IY
KELSEA	K EH L S IY AH
KELSEY	K EH L S IY
KELSI	K EH L S IY
KELSIE	K EH L S AY
KELTON	K EH L T AH N
KELVIN	K EH L V AH N
KELVIN(2)	K EH L V IH N
KEM	K EH M
KEN	K EH N
KENAN	K IY N AH N
KENDAL	K EH N D AH L
KENDALL	K EH N D AH L
KENDELL	K EH N D AH L
KENDRA	K EH N D R AH
KENDRICK	K EH N D R IH K
KENIA	K IY N Y AH
KENISHA	K EH N AH SH AH
KENJI	K EH N JH IY
KENLEY	K EH N L IY
KENNA	K EH N AH
KENNARD	K EH N ER D
KENNEDI	K EH N AH D IY
KENNEDY	K EH N AH D IY
KENNETH	K EH N IH TH
KENNEY	K EH N IY
KENNITH	K EH N IY TH
KENNTH	K EH N TH
KENNY	K EH N IY
KENT	K EH N T
KENTON	K EH N T AH N
KENYA	K EH N Y AH
KENYA(2)	K IY N Y AH
KENYATTA	K EH N AY AE T AH
KENYON	K EH N Y AH N
KENZIE	K EH N Z IY
KEON	K IY AH N
KERI	K EH R IY
KERMIT	K ER M IH T
KERRI	K EH R IY
KERRIE	K EH R AY
KERRY	K EH R IY
KERWIN	K ER W IH N
KESHA	K EH SH AH
KESHAUN	K EH SH AH N
KESHAWN	K EH SH AH N
KESHIA	K EH SH IY AH
KEVAN	K EH V AH N
KEVEN	K IY V AH N
KEVIN	K EH V IH N
KEVON	K EH V AH N
KEYLA	K EY L AH
KEYON	K IY AO N
KEYSHAWN	K EY SH AH N
KHADIJAH	K HH AE D AH JH AH
KHALID	K AA L IH D
KHALID(2)	HH AA L IH D
KHALIL	K AE L AH L
KHALILAH	K HH AE L AH L AH
KHARI	K HH AE R IY
KHIRY	K HH IH R IY
KHLOE	K HH L OW
KIA	K IY ER
KIAN	K IY AH N
KIANA	K AY AH N AH
KIANNA	K AY AE N AH
KIARA	K AY AH R AH
KIARRA	K AY AE R AH
KIEFER	K IY F ER
KIEL	K IY L
KIERA	K IY R AH
KIERAN	K IY R AH N
KIERRA	K IY R AH
KIERSTEN	K IY R S T AH N
KIETH	K AY AH TH
KILEY	K AY L IY
KILLIAN	K IH L Y AH N
KIM	K IH M
KIMBALL	K IH M B AH L
KIMBER	K IH M B ER
KIMBERELY	K IH M B IH R L IY
KIMBERLEE	K IH M B AH R L IY IY
KIMBERLEY	K IH M B ER L IY
KIMBERLI	K IH M B AH R L IY
KIMBERLIE	K IH M B AH R L AY
KIMBERLY	K IH M B ER L IY
KIMORA	K IH M AH R AH
KINDRA	K IH N D R AH
KING	K IH NG
KINGSTON	K IH NG S T AH N
KINLEY	K IH N L IY
KINSEY	K IH N Z IY
KINSLEY	K IH N Z L IY
KINTE	K IH N T
KIP	K IH P
KIPP	K IH P
KIRA	K IY R AA
KIRBY	K ER B IY
KIRK	K ER K
KIRSTEN	K ER S T AH N
KIRSTIE	K ER S T IY
KIRSTIN	K ER S T IH N
KIRT	K ER T
KISHA	K IH SH AH
KIT	K IH T
KITTIE	K IH T IY
KITTY	K IH T IY
KIYA	K AY AY AH
KIYOKO	K AY AY AH K OW
KIYOSHI	K IY OW SH IY
KIZZIE	K IH Z AY
KIZZY	K IH Z IY
KNOX	N AA K S
KNUTE	K N UW T
KOBE	K OW B EY
KOBY	K OW B IY
KODA	K OW D AH
KODY	K OW D IY
KOEN	K OW N
KOLBY	K OW L B IY
KOLE	K OW L
KOLTEN	K OW L T AH N
KOLTON	K OW L T AH N
KONNER	K AA N ER
KONNOR	K AA N AH R
KORBIN	K AO R B AH N
KORDELL	K AO R D EH L
KOREY	K AO R IY
KORI	K AO R IY
KORTNEY	K AO R T N IY
KORY	K AO R IY
KOURTNEY	K AH R T N IY
KRAIG	K R EY G
KRIS	K R IH S
KRISH	K R IH SH
KRISSY	K R IH S IY
KRISTA	K R IH S T AH
KRISTAL	K R IH S T AH L
KRISTAN	K R IH S T AH N
KRISTEN	K R IH S T AH N
KRISTI	K R IH S T IY
KRISTIAN	K R IH S AH N
KRISTIE	K R IH S T IY
KRISTIN	K R IH S T IH N
KRISTINA	K R IH S T IY N AH
KRISTINE	K R IH S T IY N
KRISTOFER	K R IH S T OW F AH R
KRISTOFFER	K R IH S T AA F AH R
KRISTOPHER	K R IH S T AH F ER
KRISTY	K R IH S T IY
KRISTYN	K R IH S T AH N
KRYSTA	K R IH S T AH
KRYSTAL	K R IH S T AH L
KRYSTEN	K R IH S AH N
KRYSTIN	K R IH S T AH N
KRYSTINA	K R IH S T AH N AH
KRYSTLE	K R IH S AH L
KUNTA	K AH N T AH
KURT	K ER T
KURTIS	K ER T IH S
KWAME	K W EY M
KYA	K AY AH
KYAN	K AY AH N
KYARA	K AY AH R AH
KYLA	K IH L AH
KYLAH	K IH L AH
KYLAN	K AY L AH N
KYLE	K AY L
KYLEE	K AY L IY IY
KYLEIGH	K IH L EY
KYLENE	K AH L IY N
KYLER	K AY L ER
KYLIE	K AY L IY
KYMANI	K IH M AH N IY
KYRA	K AY R AH
KYREE	K AY R IY IY
KYRIE	K IH R AY
KYSON	K IH S AH N
LACEY	L EY S IY
LACI	L AE S IY
LACIE	L EY S IY
LACY	L EY S IY
LADARIUS	L AH D AE R AY AH S
LADDIE	L AE D IY
LADONNA	L AH D AA N AH
LADY	L EY D IY
LAFAYETTE	L AA F IY EH T
LAFAYETTE(2)	L AA F EY EH T
LAFE	L EY F
LAHOMA	L AE HH AH M AH
LAILA	L EY L AH
LAILAH	L EY L AH
LAINEY	L EY N IY
LAISHA	L EY SH AH
LAKEISHA	L EY K IY SH AH
LAKEN	L EY K AH N
LAKENDRA	L AH K EH N D R AH
LAKESHA	L AE K AH SH AH
LAKESHIA	L AH K EH SH IY AH
LAKISHA	L AE K AH SH AH
LALA	L AA L AH
LALLA	L AE L AH
LAMAR	L AA M AA R
LAMARCUS	L AH M AA R K AH S
LAMBERT	L AE M B ER T
LAMONT	L AH M AA N T
LAMONTE	L AA M AA N T
LANA	L AE N AH
LANCE	L AE N S
LANDAN	L AE N D AH N
LANDEN	L AE N D AH N
LANDIN	L AE N D IH N
LANDON	L AE N D AH N
LANDYN	L AE N D AH N
LANE	L EY N
LANETTE	L EY N EH T
LANEY	L EY N IY
LANI	L AA N IY
LANIE	L EY N IY
LANITA	L AE N AH T AH
LANNIE	L AE N AY
LANNY	L AE N IY
LAQUAN	L AE K W AH N
LAQUITA	L AE K W AH T AH
LARA	L AA R AH
LARAE	L AE R IY
LARAINE	L ER EY N
LARISSA	L AA R IY S AH
LARK	L AA R K
LARKIN	L AA R K IH N
LARON	L AE R AH N
LARRY	L EH R IY
LARS	L AA R Z
LARUE	L ER UW
LARY	L EH R IY
LASHANDA	L AH SH AE N D AH
LASHAWN	L AE SH AH N
LASHONDA	L AH SH AA N D AH
LASHUNDA	L AH SH AH N D AH
LASONYA	L AH S AA N AY AH
LASSIE	L AE S IY
LATANYA	L AH T AE N AY AH
LATARSHA	L AH T AA R SH AH
LATASHA	L AH T AA SH AH
LATESHA	L AE T AH SH AH
LATIFAH	L AE T AH F AH
LATISHA	L AH T IH SH AH
LATONIA	L AA T OW N IY AH
LATONYA	L AH T AA N AY AH
LATORIA	L AH T AO R IY AH
LATOSHA	L AE T AH SH AH
LATOYA	L AH T OY AH
LATOYIA	L AH T OY IY AH
LATRELL	L AE T R AH L
LATRICE	L AE T R AH S
LATRICIA	L AE T R IH SH IY AH
LATRINA	L AE T R AH N AH
LAUNA	L AO N AH
LAURA	L AO R AH
LAURANCE	L AO R AH N S
LAUREEN	L AO R IY N
LAUREL	L AO R AH L
LAUREN	L AO R AH N
LAURENCE	L AO R AH N S
LAURENE	L AO R IY N
LAURETTA	L ER EH T AH
LAURETTE	L AO R EH T
LAURI	L AO R IY
LAURI(2)	L AA R IY
LAURIE	L AO R IY
LAURIE(2)	L AA R IY
LAURINE	L AH R AY N
LAURYN	L AO R AH N
LAVADA	L AE V AH D AH
LAVAR	L EY V AH R
LAVELLE	L AH V EH L
LAVENIA	L AH V IY N Y AH
LAVERA	L AE V AH R AH
LAVERN	L AE V AH R N
LAVERNA	L AH V AH R N AH
LAVERNE	L AH V ER N
LAVINA	L AA V IY N AH
LAVINIA	L AH V IH N Y AH
LAVON	L AE V AH N
LAVONA	L AE V AH N AH
LAVONDA	L AH V AA N D AH
LAVONIA	L AH V OW N Y AH
LAVONNE	L AE V AH N
LAWANDA	L AO AE N D AH
LAWERENCE	L AO ER AH N S
LAWRANCE	L AO R AH N S
LAWRENCE	L AO R AH N S
LAWSON	L AO S AH N
LAWTON	L AO T AH N
LAWYER	L AO Y ER
LAWYER(2)	L OY ER
LAYLA	L EY L AA
LAYLAH	L EY L AH
LAYNE	L EY N
LAYTON	L EY T AH N
LAZARO	L AH Z AA R OW
LE	L AH
LEA	L IY
LEAFY	L IY F IY
LEAH	L IY AH
LEALA	L IY L AH
LEAMON	L IY M AH N
LEANA	L IY N AH
LEANDER	L IY AE N D ER
LEANDRA	L IY N D R AH
LEANDRO	L IY AA N D R OW
LEANER	L IY N ER
LEANN	L IY AE N
LEANNA	L IY N AH
LEANNE	L IY N
LEATHA	L IY TH AH
LEATRICE	L IY T R IH S
LEDA	L IY D AH
LEE	L IY
LEEANN	L IY AH N
LEEROY	L IY R OW IY
LEESA	L IY S AH
LEIA	L EY AA
LEIF	L IY F
LEIGH	L IY
LEIGHTON	L EY T AH N
LEILA	L IY L AH
LEILANI	L AH L AA N IY
LEISA	L IY S AH
LEISHA	L IY SH AH
LEITHA	L IY DH AH
LELA	L IY L AH
LELAH	L EH L AH
LELAND	L IY L AH N D
LELAR	L IY L AH R
LELIA	L IY L Y AH
LELLA	L EH L AH
LEM	L EH M
LEMMA	L EH M AH
LEMMIE	L EH M IY
LEMON	L EH M AH N
LEMPI	L EH M P IY
LEMUEL	L EH M Y UW AH L
LEN	L EH N
LENA	L IY N AH
LENARD	L EH N ER D
LENNA	L EH N AH
LENNIE	L EH N IY
LENNON	L EH N AH N
LENNY	L EH N IY
LENON	L EH N AH N
LENORA	L EH N ER AH
LENORD	L EH N AH R D
LENORE	L AH N AO R
LENWOOD	L EH N W UW D
LEO	L IY OW
LEOLA	L EH L AH
LEOMA	L IH OW M AH
LEON	L IY AA N
LEONA	L IY OW N AH
LEONARD	L EH N ER D
LEONARDO	L IY AH N AA R D OW
LEONCE	L IY AH N S
LEONE	L IY OW N
LEONEL	L IY OW N AH L
LEONIA	L IY OW N Y AH
LEONIDAS	L IY AO N IY D AH Z
LEONIE	L EH N IY
LEONOR	L IY AH N AH R
LEONORA	L IY AH N AO R AH
LEONORE	L IY AH N AO R
LEONTINE	L EH N T IY N IY
LEONTINE(2)	L IY AA N T AY N
LEOPOLD	L IY AH P OW L D
LEOPOLDO	L IY AH P OW L D OW
LEORA	L EH R AH
LEOTA	L EH T AH
LERA	L EH R AH
LEROY	L IY R OY
LES	L EH S
LES(2)	L EY
LESA	L IY S AH
LESIA	L IY ZH IY AH
LESLEE	L EH Z L IY IY
LESLEY	L EH S L IY
LESLI	L EH Z L IY
LESLIE	L EH S L IY
LESLY	L Z L IY
LESS	L EH S
LESSIE	L EH S IY
LESTA	L EH S T AH
LESTER	L EH S T ER
LETA	L EH T AH
LETHA	L EH TH AH
LETHIA	L EH TH IY AH
LETICIA	L AH T IH SH AH
LETITIA	L IH T IH SH IY AH
LETTA	L EH T AH
LETTIE	L EH T IY
LETTY	L EH T IY
LEVA	L EH V AH
LEVAR	L IY V AH R
LEVERN	L EH V AH R N
LEVI	L IY V AY
LEVIE	L IY V IY
LEVIN	L EH V IH N
LEVIN(2)	L AH V IH N
LEVINA	L EH V IY N AH
LEVON	L EH V AH N
LEVY	L EH V IY
LEVY(2)	L IY V IY
LEW	L UW
LEWIS	L UW IH S
LEX	L EH K S
LEXI	L EH K S IY
LEXIE	L EH K S IY
LEXIS	L EH K S IH S
LEXUS	L EH K S AH S
LEYLA	L EY L AH
LIA	L IY AH
LIAM	L IY AH M
LIANA	L IY AA N AH
LIANE	L IY AE N
LIBBIE	L IH B AY
LIBBY	L IH B IY
LIBERTY	L IH B ER T IY
LIDA	L IY D AH
LIDDIE	L IH D IY
LIDIA	L IH D IY AH
LIDIE	L IH D IY
LIGE	L AY JH
LILA	L IY L AH
LILAH	L IH L AH
LILBURN	L IH L B AH R N
LILIA	L IY L IY AH
LILIAN	L IH L IY AH N
LILIAN(2)	L IH L Y AH N
LILIANA	L IH L IY AE N AH
LILIANNA	L IH L IY AE N AH
LILIE	L IH L AY
LILLA	L IH L AH
LILLARD	L IH L ER D
LILLER	L IH L ER
LILLIA	L IH L IY AH
LILLIAN	L IH L IY AH N
LILLIANA	L IH L IY AE N AH
LILLIANNA	L IH L IY AE N AH
LILLIE	L IH L IY
LILLIS	L IH L IH S
LILLY	L IH L IY
LILY	L IH L IY
LILYAN	L IH L IY AH N
LILYANA	L AH L AY AH N AH
LIM	L IH M
LINA	L IY N AH
LINCOLN	L IH NG K AH N
LINDA	L IH N D AH
LINDBERGH	L IH N D B ER G
LINDELL	L IH N D AH L
LINDEN	L IH N D AH N
LINDSAY	L IH N D Z IY
LINDSEY	L IH N D Z IY
LINDY	L IH N D IY
LINETTE	L IH N EH T
LINK	L IH NG K
LINN	L IH N
LINNA	L IH N AH
LINNEA	L IH N IY AH
LINNIE	L IH N AY
LINSEY	L IH N Z IY
LINTON	L IH N T AH N
LINUS	L AY N AH S
LINWOOD	L IH N W UH D
LINZY	L IH N Z IY
LIONEL	L AY AH N AH L
LISA	L IY S AH
LISANDRO	L AH S AE N D R OW
LISBETH	L IH S B IH TH
LISE	L AY Z
LISETTE	L IH S EH T
LISH	L IH SH
LISHA	L IH SH AH
LISLE	L AY AH L
LISSA	L IH S AH
LISSETTE	L IH S EH T
LISSIE	L IH S IY
LISTON	L IH S T AH N
LITA	L IY T AH
LITHA	L IH TH AH
LITTIE	L IH T IY
LITTLE	L IH T AH L
LITTLETON	L IH T AH L T AH N
LITZY	L IH T S IY
LIVIA	L IH V IY AH
LIZ	L IH Z
LIZA	L IY Z AH
LIZABETH	L IH Z AH B EH TH
LIZBETH	L IH Z AH TH
LIZETH	L AY Z AH TH
LIZETTE	L AY Z EH T
LIZZIE	L IH Z IY
LLEWELLYN	L UW EH L IH N
LLOYD	L OY D
LOCKIE	L AA K IY
LODA	L OW D AH
LOGAN	L OW G AH N
LOIS	L OW AH S
LOLA	L OW L AH
LOLITA	L OW L IY T AH
LOLLA	L AA L AH
LOLLIE	L AA L IY
LOMA	L OW M AH
LON	L AA N
LONA	L OW N AH
LONDON	L AH N D AH N
LONDYN	L AA N D AH N
LONE	L OW N
LONEY	L OW N IY
LONG	L AO NG
LONI	L AA N IY
LONIE	L OW N IY
LONNA	L AA N AH
LONNIE	L AO N IY
LONNY	L AO N IY
LONZO	L AA N Z OW
LORA	L AO R AH
LORAINE	L ER EY N
LORAN	L AO R AE N
LORAYNE	L AH R EY N
LOREAN	L AO R IY AH N
LOREE	L AO R IY
LOREEN	L OW R AH N
LORELAI	L AO R AH L EY
LORELEI	L AO R IH L AY
LOREN	L AO R AH N
LORENA	L AO R EH N AH
LORENE	L AO R IY N
LORENZ	L ER EH N T S
LORENZA	L AO R EH N Z AH
LORENZO	L ER EH N Z OW
LORENZO(2)	L AO EH N Z OW
LORETTA	L ER EH T AH
LORETTO	L AO R EH T OW
LORI	L AO R IY
LORIA	L AO R IY AH
LORIANN	L AO R IY AH N
LORIE	L AO R IY
LORIN	L AO R IH N
LORINDA	L AH R IH N D AH
LORINE	L AH R AY N
LORING	L AO R IH NG
LORIS	L AO R IH S
LORNA	L AO R N AH
LORNE	L AO R N
LORRAINE	L ER EY N
LORRAYNE	L AO R EY N
LORRI	L AO R IY
LORRIE	L AO R IY
LOSSIE	L AO S IY
LOTA	L OW T AH
LOTT	L AA T
LOTTA	L AA T AH
LOTTIE	L AA T IY
LOU	L UW
LOUANN	L AW AH N
LOUANNA	L AW AA N AH
LOUANNA(2)	L UW AE N AH
LOUELLA	L AW EH L AH
LOUETTA	L AW EH T AH
LOUIE	L UW IY
LOUIS	L UW IH S
LOUIS(2)	L UW IY
LOUISA	L UW IY Z AH
LOUISE	L UW IY Z
LOUISIANA	L UW IY Z IY AE N AH
LOULA	L AW L AH
LOURDES	L AO R D Z
LOUVENIA	L AW V IY N Y AH
LOVE	L AH V
LOVELL	L AH V AH L
LOVETT	L AH V IH T
LOVEY	L AH V IY
LOVIE	L AH V IY
LOVINA	L AA V AH N AH
LOVISA	L AA V AH S AH
LOWELL	L OW AH L
LOY	L OY
LOYAL	L OY AH L
LOYCE	L OY S
LOYD	L OY D
LU	L UW
LUANA	L UW AE N AH
LUANN	L UW W AH N
LUANNE	L UW W AH N
LUBERTA	L UW B AH R T AH
LUC	L UW K
LUCA	L UW K AH
LUCAS	L UW K AH S
LUCERO	L UW CH EH R OW
LUCETTA	L UW S EH T AH
LUCIA	L UW SH AH
LUCIAN	L UW SH AH N
LUCIANA	L UW S IY AH N AH
LUCIANO	L UW CH IY AA N OW
LUCIE	L UW S IY
LUCIEN	L UW S IY EH N
LUCILE	L UW S IY L
LUCILLE	L UW S IY L
LUCINA	L UW S AH N AH
LUCINDA	L UW S IH N D AH
LUCINDY	L UW S AY N D IY
LUCIO	L UW S IY OW
LUCIOUS	L UW S IY AH S
LUCIUS	L UW SH AH S
LUCKY	L AH K IY
LUCRETIA	L UW K R IY SH AH
LUCY	L UW S IY
LUDA	L UW D AH
LUDIE	L UW D AY
LUDWIG	L AH D W IH G
LUE	L UW
LUELLA	L UW EH L AH
LUETTA	L UW EH T AH
LUGENIA	L UW JH IY N Y AH
LUIGI	L UW IY JH IY
LUIS	L UW IY S
LUISA	L UW IY Z AH
LUKA	L UW K AH
LUKAS	L UW K AH Z
LUKE	L UW K
LULA	L UW L AH
LULAH	L UW L AH
LULAR	L UW L AH R
LULIE	L AH L IY
LULLA	L AH L AH
LULU	L UW L UW
LUM	L AH M
LUNA	L UW N AH
LUPE	L UW P
LURA	L UH R AH
LURANA	L UH R AH N AH
LURENA	L UH R AH N AH
LURLINE	L ER L AY N
LUSTER	L AH S T ER
LUTE	L UW T
LUTHER	L UW TH ER
LUTIE	L UW T IY
LUVENIA	L UW V IY N Y AH
LUVERNE	L UW V AH R N
LUVINIA	L UW V IH N Y AH
LUZ	L AH Z
LYDA	L AY D AH
LYDELL	L IH D AH L
LYDIA	L IH D IY AH
LYLA	L IH L AH
LYLE	L AY L
LYMAN	L AY M AH N
LYN	L IH N
LYNDA	L IH N D AH
LYNDIA	L IH N D IY AH
LYNDON	L IH N D AH N
LYNDSAY	L IH N D S EY IY
LYNDSEY	L IH N D Z IY
LYNETTE	L AY N EH T
LYNETTE(2)	L IH N EH T
LYNN	L IH N
LYNNE	L IH N
LYNNETTE	L IH N EH T
LYNSEY	L IH N Z IY
LYNWOOD	L IH N W UW D
LYRIC	L IH R IH K
MABEL	M EY B AH L
MABELL	M AE B AH L
MABELLE	M AH B EH L
MABLE	M EY B AH L
MAC	M AE K
MACARTHUR	M AH K AA R TH ER
MACE	M EY S
MACEL	M AE S AH L
MACEO	M EY S IY OW
MACEY	M EY S IY
MACHELLE	M AE CH AH L
MACI	M AE S IY
MACIE	M EY S AY
MACK	M AE K
MACKENZIE	M AH K EH N Z IY
MACY	M EY S IY
MADALINE	M AE D AH L AY N
MADALYN	M AE D AH L AH N
MADALYNN	M AE D AH L AH N
MADDEN	M AE D AH N
MADDISON	M AE D IH S AH N
MADDOX	M AE D AH K S
MADELEINE	M AE D AH L EH N
MADELENE	M AE D AH L IY N
MADELINE	M AE D AH L IH N
MADELYN	M AE D IH L IH N
MADELYN(2)	M AE D L IH N
MADELYNN	M AE D AH L AH N
MADGE	M AE JH
MADIE	M AE D IY
MADILYN	M AE D AH L AH N
MADILYNN	M AE D AH L AH N
MADISEN	M AE D IY Z AH N
MADISON	M AE D AH S AH N
MADISON(2)	M AE D IH S AH N
MADISYN	M AE D AH S AH N
MADLYN	M AE D L AH N
MADONNA	M AH D AA N AH
MADORA	M AH D AO R AH
MADYSON	M AE D IY S AH N
MAE	M EY
MAEBELL	M IY B AH L
MAEBELLE	M IY B AH L
MAEGAN	M IY G AH N
MAEVE	M AH EH V
MAFALDA	M AH F AE L D AH
MAGAN	M EY G AH N
MAGDALEN	M AE G D AH L AH N
MAGDALENA	M AE G D AH L IY N AH
MAGDALENE	M AE G D AH L IY N
MAGEN	M EY JH AH N
MAGGIE	M AE G IY
MAGNOLIA	M AE G N OW L Y AH
MAHALA	M AE HH AH L AH
MAHALIA	M AH HH AE L IY AH
MAHALIE	M AH HH EY L AY
MAHLON	M EY L AO N
MAI	M AY
MAIA	M AY AH
MAIDA	M EY D AH
MAIRA	M AE AH R AH
MAIYA	M EY AY AH
MAJOR	M EY JH ER
MAKAI	M AE K EY
MAKAILA	M AH K EY L AH
MAKALA	M AE K AH L AH
MAKAYLA	M AH K EY L AH
MAKENA	M AE K AH N AH
MAKENNA	M AH K EH N AH
MAKENZIE	M AH K EH N Z AY
MAKHI	M AE K IY
MAL	M AE L
MALACHI	M AH L AE CH IY
MALAKAI	M AH L AE K EY
MALAKI	M AH L AE K IY
MALAYA	M AH L EY AH
MALCOLM	M AE L K AH M
MALCOM	M AE L K AH M
MALE	M EY L
MALEAH	M AH L IY AH
MALIA	M AA L IY AH
MALIK	M AE L IH K
MALINDA	M AA L IY N D AH
MALISSA	M AH L IH S AH
MALISSIE	M EY L IY Z IY
MALIYAH	M AH L AY AY AH
MALLIE	M AO L IY
MALLORIE	M AE L IY ER IY
MALLORY	M AE L ER IY
MALORIE	M AE L OW R IY
MALVIN	M AE L V IH N
MALVINA	M AA L V IY N AH
MAME	M EY M
MAMIE	M EY M IY
MAMMIE	M AE M AY
MANDA	M AE N D AH
MANDI	M AE N D IY
MANDIE	M AE N D IY
MANDY	M AE N D IY
MANERVA	M AH N AH R V AH
MANERVIA	M AH N AH R V IY AH
MANFORD	M AE N F ER D
MANIE	M EY N IY
MANILA	M AH N IH L AH
MANILLA	M AH N IH L AH
MANLEY	M AE N L IY
MANLY	M AE N L IY
MANNIE	M AE N IY
MANNING	M AE N IH NG
MANSFIELD	M AE N Z F IY L D
MANSON	M AE N S AH N
MANUEL	M AA N W EH L
MANUELA	M AE N W EY L AH
MANUELITA	M AE N Y UW EH L AH T AH
MARA	M AA R AH
MARALYN	M AE R AH L AH N
MARANDA	M ER AE N D AH
MARC	M AA R K
MARCEL	M AA R S EH L
MARCELA	M AA R CH EH L AH
MARCELINA	M AA R S EH L AH N AH
MARCELINE	M AA R S AH L AY N
MARCELINO	M AA R CH EH L IY N OW
MARCELLA	M AA R S EH L AH
MARCELLE	M AA R S EH L
MARCELLO	M AA R S EH L OW
MARCELLUS	M AA R S EH L AH S
MARCELO	M AA R CH EH L OW
MARCHELLO	M AA R K EH L OW
MARCI	M AA R S IY
MARCIA	M AA R SH AH
MARCIE	M AA R K IY
MARCO	M AA R K OW
MARCOS	M AA R K OW S
MARCUS	M AA R K AH S
MARCY	M AA R S IY
MARDELL	M AA R D EH L
MARELI	M AE R AH L IY
MARELY	M EH R L IY
MAREN	M EH R AH N
MARGARET	M AA R G ER IH T
MARGARET(2)	M AA R G R AH T
MARGARET(3)	M AA R G R IH T
MARGARETE	M AA R G ER IY T
MARGARETHA	M AA R G AE R AH TH AH
MARGARETT	M AA R G AH R AH T
MARGARETTA	M AA R G AH R EH T AH
MARGARETTE	M AA R G AH R EH T
MARGARITA	M AA R G ER IY T AH
MARGARITE	M AA R G AH R AY T
MARGARITO	M AA R G AE R AH T OW
MARGE	M AA R JH
MARGENE	M AA R JH IY N
MARGERET	M AA R JH AH R AH T
MARGERY	M AA R JH ER IY
MARGET	M AA R G IH T
MARGIE	M AA R JH IY
MARGO	M AA R G OW
MARGOT	M AA R G OW
MARGRET	M AA R G R EH T
MARGRETT	M AA R G R AH T
MARGRETTA	M AA R G R EH T AH
MARGUERITE	M AA R G ER IY T
MARGUERITTA	M AA R G Y UW AH R IH T AH
MARGURITE	M AA R G Y AH R AY T
MARGY	M AA R JH IY
MARI	M AA R IY
MARIA	M ER IY AH
MARIAH	M ER AY AH
MARIAM	M AA R IY AH M
MARIAN	M AA R IY AH N
MARIANA	M AA R IY AE N AH
MARIANITA	M AE R IY AE N AH T AH
MARIANN	M AE R IY AH N
MARIANNA	M AA R IY AA N AH
MARIANNE	M AA R IY AE N
MARIANO	M AA R IY AA N OW
MARIBEL	M AA R IH B EH L
MARIBETH	M AE R AH B AH TH
MARICELA	M AH R IH S AH L AH
MARIE	M ER IY
MARIEL	M EH R IY AH L
MARIELA	M AH R IY L AH
MARIETTA	M EH R IY EH T AH
MARILEE	M AE R AH L IY IY
MARILLA	M AA R IH L AH
MARILOU	M AE R AH L UW
MARILYN	M EH R AH L AH N
MARILYN(2)	M EH R AH L IH N
MARILYNN	M EH R AH L AH N
MARIN	M EH R IH N
MARINA	M ER IY N AH
MARINDA	M AH R IH N D AH
MARIO	M AA R IY OW
MARION	M EH R IY AH N
MARISA	M AA R IH S AH
MARISELA	M AH R IH S AH L AH
MARISOL	M AE R AH S AH L
MARISSA	M AA R IH S AH
MARITA	M AE R AH T AH
MARITZA	M AH R IH T S AH
MARIUS	M AA R IY AH S
MARIYAH	M AH R IY AY AH
MARJORIE	M AA R JH ER IY
MARJORIE(2)	M AA R JH R IY
MARJORY	M AA R JH ER IY
MARJORY(2)	M AA R JH R IY
MARK	M AA R K
MARKEL	M AA R K EH L
MARKELL	M AA R K EH L
MARKITA	M AA R K AH T AH
MARKUS	M AA R K AH S
MARLA	M AA R L AH
MARLANA	M AA R L AH N AH
MARLAND	M AA R L AH N D
MARLEE	M AA R L IY
MARLEEN	M AA R L IY N
MARLEN	M AA R L AH N
MARLENA	M AA R L EY N AH
MARLENE	M AA R L IY N
MARLEY	M AA R L IY
MARLIE	M AA R L AY
MARLIN	M AA R L AH N
MARLIN(2)	M AA R L IH N
MARLO	M AA R L OW
MARLON	M AA R L AH N
MARLYN	M AA R L AH N
MARLYS	M AA R L IY Z
MARNI	M AA R N IY
MARNIE	M AA R N IY
MARNITA	M AA R N AH T AH
MAROLYN	M AE R AH L AH N
MARQUES	M AA R K S
MARQUEZ	M AA R K EH Z
MARQUIS	M AA R K IY
MARQUISE	M AA R K W AY Z
MARQUITA	M AA R K W IY T AH
MARRION	M AA R IY AH N
MARRY	M EH R IY
MARSH	M AA R SH
MARSHA	M AA R SH AH
MARSHAL	M AA R SH AH L
MARSHALL	M AA R SH AH L
MART	M AA R T
MARTA	M AA R T AH
MARTELL	M AA R T EH L
MARTEZ	M AA R T AH Z
MARTHA	M AA R TH AH
MARTI	M AA R T IY
MARTIKA	M AA R T AH K AH
MARTIN	M AA R T AH N
MARTIN(2)	M AA R T IH N
MARTINA	M AA R T IY N AH
MARTINE	M AA R T IY N
MARTY	M AA R T IY
MARVA	M AA R V AH
MARVEL	M AA R V AH L
MARVIN	M AA R V IH N
MARY	M EH R IY
MARYAM	M AE R AY AH M
MARYANN	M EH R IY AE N
MARYANNE	M EH R IY AE N
MARYBELLE	M EH R IY B EH L
MARYBETH	M EH R IY B EH TH
MARYELLEN	M AA R Y EH L AH N
MARYJANE	M AE R AH JH EY N
MARYJO	M AE R AH JH OW
MARYLEE	M EH R IY L IY
MARYLIN	M AE R IH L IH N
MARYLOU	M AE R IY L UW
MARYLOUISE	M AH R IH L AW AY Z
MARYLYN	M AE R AH L AH N
MASAKO	M AH S AA K OW
MASAO	M AA S AA OW
MASON	M EY S AH N
MAT	M AE T
MATEO	M AA T EY OW
MATH	M AE TH
MATHEW	M AE TH Y UW
MATHEWS	M AE TH Y UW Z
MATHIAS	M AH TH AY AH S
MATHIAS(2)	M AH T IY AH S
MATHILDA	M AH T IH L D AH
MATHILDE	M AE TH IH L D
MATHILDE(2)	M AH T IH L D
MATIAS	M AA SH AH Z
MATIE	M EY T IY
MATILDA	M AH T IH L D AH
MATILDE	M AE T AH L D
MATT	M AE T
MATTEO	M AA T EY OW
MATTHEW	M AE TH Y UW
MATTHIAS	M AH TH AY AH S
MATTIE	M AE T IY
MATTYE	M AE T AY
MAUD	M AO D
MAUDE	M AO D
MAUDIE	M AO D AY
MAURA	M AO R AH
MAUREEN	M AO R IY N
MAURICE	M AO R IY S
MAURICE(2)	M AA R IH S
MAURICIO	M AW R IY S IY OW
MAURINE	M AO R IY N IY
MAURO	M AO R OW
MAURY	M AO R IY
MAVERICK	M AE V ER IH K
MAVERICK(2)	M AE V R IH K
MAVIS	M EY V IH S
MAX	M AE K S
MAXIE	M AE K S IY
MAXIM	M AE K S AH M
MAXIMILIAN	M AE K S IH M IH L IY AH N
MAXIMILLIAN	M AE K S AH M IH L IY AH N
MAXIMO	M AE K S AH M OW
MAXIMUS	M AE K S IH M AH S
MAXINE	M AE K S IY N
MAXWELL	M AE K S W EH L
MAY	M EY
MAYA	M AY AH
MAYBELL	M EY B EH L
MAYBELLE	M EY B EH L
MAYE	M EY
MAYME	M EY M
MAYMIE	M EY M AY
MAYNARD	M EY N ER D
MAYO	M EY OW
MAYRA	M EY R AH
MAZIE	M EY Z IY
MCARTHUR	M AH K AA R TH ER
MCKAYLA	M K EY L AH
MCKENNA	M AH K EH N AH
MCKENZIE	M AH K EH N Z IY
MCKINLEY	M AH K IH N L IY
MEADOW	M EH D OW
MEAGAN	M IY AH JH AH N
MEAGHAN	M IY AH N
MEARL	M AH R L
MECHELLE	M EH CH AH L
MEDA	M EY D AH
MEDIA	M IY D IY AH
MEDORA	M EY D AO R AH
MEG	M EH G
MEGAN	M EY G AH N
MEGGAN	M EH G AH N
MEGHAN	M EH G AH N
MEGHANN	M EH AH N
MEKHI	M EH K IY
MEL	M EH L
MELANIE	M EH L AH N IY
MELANY	M EH L AH N IY
MELBA	M EH L B AH
MELBOURNE	M EH L B ER N
MELBOURNE(2)	M EH L B AO N
MELINA	M EH L IY N AH
MELINDA	M AH L IH N D AH
MELISA	M EH L AH S AH
MELISSA	M AH L IH S AH
MELISSIA	M AH L IH SH IY AH
MELL	M EH L
MELLIE	M EH L IY
MELLISA	M EH L AH S AH
MELLISSA	M EH L IH S AH
MELODEE	M EH L AH D IY IY
MELODIE	M AH L OW D AY
MELODY	M EH L AH D IY
MELONIE	M EH L AH N IY
MELONY	M EH L AH N IY
MELTON	M EH L T AH N
MELVA	M EH L V AH
MELVILLE	M EH L V IH L
MELVIN	M EH L V IH N
MELVINA	M EH L V IY N AH
MELVYN	M EH L V IH N
MEMPHIS	M EH M F AH S
MEMPHIS(2)	M EH M F IH S
MEMPHIS(3)	M EH M P F AH S
MEMPHIS(4)	M EH M P F IH S
MENA	M IY N AH
MENACHEM	M AH N AA HH AH M
MENACHEM(2)	M EH N AH HH EH M
MENDY	M EH N D IY
MERCEDES	M ER S EY D IY Z
MERCER	M ER S ER
MERCY	M ER S IY
MEREDITH	M EH R IH D IH TH
MERILYN	M EH R AH L AH N
MERL	M ER L
MERLE	M ER L
MERLENE	M AH R L IY N
MERLIN	M ER L IH N
MERLYN	M AH R L AH N
MERNA	M EH R N AH
MERRI	M EH R IY
MERRIE	M EH R IY
MERRILEE	M EH R AH L IY IY
MERRILL	M EH R AH L
MERRILY	M EH R AH L IY
MERRITT	M EH R IH T
MERRY	M EH R IY
MERTIE	M AH R T AY
MERTON	M ER T AH N
MERVIN	M ER V IH N
MERVYN	M ER V IH N
MERWIN	M ER W IH N
MERYL	M EH R AH L
MESSIAH	M AH S AY AH
META	M IY T AH
METHA	M EH TH AH
METRO	M EH T R OW
METTA	M EH T AH
METTIE	M EH T IY
MEYER	M AY ER
MIA	M IY AH
MIAH	M AY AH
MICAELA	M IY K EY L AH
MICAH	M AY K AH
MICAYLA	M AH K EY L AH
MICHAEL	M AY K AH L
MICHAELA	M AY K EH L AH
MICHAELE	M AH CH IY L
MICHAL	M IH CH AH L
MICHALE	M AH CH EY L
MICHEAL	M AY K AH L
MICHEL	M IH SH EH L
MICHEL(2)	M IH CH AH L
MICHEL(3)	M AY K AH L
MICHELE	M IH SH EH L
MICHELINA	M IH K AH L IY N AH
MICHELL	M IH CH AH L
MICHELLE	M IH SH EH L
MICHIAL	M IH CH AH L
MICKEY	M IH K IY
MICKIE	M IH K IY
MICKY	M IH K IY
MIESHA	M IY SH AH
MIGDALIA	M IH G D EY L Y AH
MIGNON	M IH G N AH N
MIGUEL	M IH G EH L
MIGUELANGEL	M IH G W AH L AE N JH AH L
MIKAELA	M IY K EY L AH
MIKAILA	M AH K EY L AH
MIKAL	M IY K AH L
MIKALA	M IH K AH L AH
MIKALAH	M IH K AH L AH
MIKAYLA	M AH K EY L AH
MIKE	M AY K
MIKEAL	M AY K AH L
MIKEL	M IH K AH L
MIKHAIL	M IH K EY L
MIKHAIL(2)	M IH K AY L
MILA	M AY L AH
MILAGROS	M AH L AE G R AH Z
MILAN	M AH L AA N
MILAN(2)	M IH L AA N
MILAN(3)	M AY L AE N
MILAS	M AY L AH Z
MILBURN	M IH L B ER N
MILDA	M IH L D AH
MILDRED	M IH L D R IH D
MILES	M AY L Z
MILES(2)	M AY AH L Z
MILEY	M AY L IY
MILFORD	M IH L F ER D
MILISSA	M AH L IH S AH
MILLARD	M IH L ER D
MILLER	M IH L ER
MILLICENT	M IH L IH S IH N T
MILLIE	M IH L IY
MILLS	M IH L Z
MILLY	M IH L IY
MILO	M AY L OW
MILTON	M IH L T AH N
MIMA	M IH M AH
MIMI	M IY M IY
MINA	M IY N AH
MINA(2)	M IH N AH
MINDA	M IH N D AH
MINDI	M IH N D IY
MINDY	M IH N D IY
MINER	M AY N ER
MINERVA	M AH N ER V AH
MINERVA(2)	M IH N ER V AH
MINERVIA	M AH N AH R V IY AH
MINNA	M IH N AH
MINNIE	M IH N IY
MINOR	M AY N ER
MINORU	M IH N AO R UW
MINTA	M IH N T AH
MINTIE	M IH N T IY
MIRA	M IH R AH
MIRACLE	M IH R AH K AH L
MIRANDA	M ER AE N D AH
MIREYA	M IH R EY AH
MIRIAH	M IH R AY AH
MIRIAM	M IH R IY AH M
MIRTIE	M AH R T AY
MISAEL	M AH S EH L
MISSIE	M IH S IY
MISSOURI	M AH Z UH R IY
MISSOURI(2)	M AH Z ER AH
MISSY	M IH S IY
MISTI	M IH S T IY
MISTIE	M IH S T AY
MISTY	M IH S T IY
MITCH	M IH CH
MITCHEL	M IH CH AH L
MITCHELL	M IH CH AH L
MITTIE	M IH T AY
MITZI	M IH T S IY
MIYA	M AY AY AH
MODENA	M OW D EH N AH
MOE	M OW
MOESHA	M OW IY SH AH
MOHAMED	M OW HH AA M EH D
MOHAMMAD	M OW HH AA M EH D
MOHAMMED	M OW HH AE M IH D
MOIRA	M OY R AH
MOISES	M OY Z IH Z
MOLLIE	M AA L IY
MOLLY	M AA L IY
MONA	M OW N AH
MONICA	M AA N IH K AH
MONIKA	M AA N AH K AH
MONIQUE	M OW N IY K
MONNA	M AA N AH
MONNIE	M AA N AY
MONROE	M AH N R OW
MONSERRAT	M AA N S EH R AH T
MONT	M AA N T
MONTANA	M AA N T AE N AH
MONTE	M AA N T IY
MONTEL	M AA N T EH L
MONTGOMERY	M AA N T G AH M R IY
MONTIE	M AA N T IY
MONTRELL	M AA N T R AH L
MONTSERRAT	M AA N S ER AA T
MONTY	M AO N T IY
MOODY	M UW D IY
MORA	M AO R AH
MORDECHAI	M AO R D AH K AY
MORGAN	M AO R G AH N
MORIAH	M AO R AY AH
MORRIS	M AO R AH S
MORRIS(2)	M AO R IH S
MORTIMER	M AO R T IH M ER
MORTON	M AO R T AH N
MOSE	M OW Z
MOSES	M OW Z AH S
MOSES(2)	M OW Z IH S
MOSHE	M OW SH EH
MOSHE(2)	M OW SH AH
MOSSIE	M AO S IY
MOZELL	M AA Z AH L
MOZELLA	M AH Z EH L AH
MOZELLE	M AH Z EH L
MUHAMMAD	M UH HH AA M AH D
MURDOCK	M ER D AA K
MURIEL	M Y UH R IY AH L
MURL	M AH R L
MURPHY	M ER F IY
MURRAY	M ER IY
MURRAY(2)	M AH R IY
MURRY	M ER IY
MUSTAFA	M UW S T AA F AH
MYA	M AY AH
MYAH	M AY AH
MYCHAL	M IH CH AH L
MYER	M AY ER
MYKEL	M IH K AH L
MYLA	M AY L AH
MYLEE	M AY L IY IY
MYLES	M AY L Z
MYLIE	M IH L AY
MYRA	M AY R AH
MYRANDA	M AH R AE N D AH
MYRL	M AH R L
MYRLE	M AH R L
MYRNA	M ER N AH
MYRON	M AY R AH N
MYRTA	M ER T AH
MYRTICE	M IH R T IH S
MYRTIE	M AH R T AY
MYRTIS	M IH R T IH S
MYRTLE	M ER T AH L
NADA	N AA D AA
NADIA	N AE D Y AH
NADIA(2)	N AA D Y AH
NADINE	N AH D IY N
NAIMA	N EY M AH
NAJEE	N EY JH IY IY
NAKIA	N EY K IY AH
NAKISHA	N AE K AH SH AH
NAKITA	N AE K AH T AH
NALLELY	N AO L IY
NAMON	N AE M AH N
NAN	N AE N
NANA	N AE N AH
NANCI	N AE N S IY
NANCIE	N AE N S AY
NANCY	N AE N S IY
NANETTE	N AH N EH T
NANIE	N EY N AY
NANNA	N AE N AH
NANNETTE	N AE N EH T
NANNIE	N AE N AY
NAOMA	N AA OW M AH
NAOMI	N EY OW M IY
NAPOLEON	N AH P OW L IY AH N
NAPOLEON(2)	N AH P OW L Y AH N
NARCISSUS	N AA R S IH S AH S
NASH	N AE SH
NASIR	N AE S AH R
NAT	N AE T
NATALEE	N EY T AH L IY
NATALIA	N AH T AA L Y AH
NATALIE	N AE T AH L IY
NATALY	N EY T AH L IY
NATALYA	N AH T AE L AY AH
NATASHA	N AH T AA SH AH
NATASHA(2)	N AH T AE SH AH
NATHALIA	N AH TH AE L IY AH
NATHALIE	N AE T AH L IY
NATHALY	N AE TH AH L IY
NATHAN	N EY TH AH N
NATHANAEL	N AE TH AH N EY L
NATHANIAL	N AH TH EY N IY AH L
NATHANIEL	N AH TH AE N Y AH L
NATHEN	N AE TH AH N
NATOSHA	N AE T AH SH AH
NAUTICA	N AO T AH K AH
NAYELI	N EY AH L IY
NAYELY	N EY L IY
NEAL	N IY L
NEALIE	N IY L AY
NEALY	N IY L IY
NED	N EH D
NEDRA	N EH D R AH
NEEDHAM	N IY D AH M
NEELY	N IY L IY
NEHA	N EH HH AH
NEHEMIAH	N IY AH M AY AH
NEIL	N IY L
NELDA	N EH L D AH
NELIA	N EH L IY AH
NELIE	N IY L AY
NELL	N EH L
NELLA	N EH L AH
NELLE	N EH L
NELLIE	N EH L IY
NELLO	N EH L OW
NELLY	N EH L IY
NELS	N EH L Z
NELSON	N EH L S AH N
NENA	N EH N AH
NEOLA	N IY AA L AH
NEOMA	N EY OW M AH
NEPPIE	N EH P AY
NEREIDA	N IY R IY D AH
NERY	N R IY
NESTOR	N EH S T ER
NETA	N EH T AH
NETTA	N EH T AH
NETTIE	N EH T IY
NEVA	N EY V AH
NEVADA	N AH V AA D AH
NEVADA(2)	N AH V AE D AH
NEVAEH	N EH V IY
NEVEAH	N IY V IY AH
NEVIN	N EH V IH N
NEWELL	N UW AH L
NEWMAN	N UW M AH N
NEWT	N UW T
NEWTON	N UW T AH N
NIA	N AY AH
NICHELLE	N IH CH AH L
NICHOL	N IH K AO L
NICHOLAS	N IH K AH L AH S
NICHOLAS(2)	N IH K L AH S
NICHOLAUS	N AH CH AA L EY AH S
NICHOLE	N IH K OW L
NICK	N IH K
NICKI	N IH K IY
NICKLAUS	N IH K L AH S
NICKOLAS	N IH K AO L AH Z
NICKY	N IH K IY
NICO	N IY K OW
NICOLA	N IH K OW L AA
NICOLAS	N IH K AO L AH S
NICOLE	N IH K OW L
NICOLETTE	N IH K AH L EH T
NICOLLE	N IH K OW L
NIGEL	N AY JH AH L
NIKHIL	N IH K AH L
NIKI	N IH K IY
NIKIA	N IH K IY AH
NIKITA	N IH K IY T AH
NIKITA(2)	N AH K IY T AH
NIKKI	N IH K IY
NIKKO	N IY K OW
NIKO	N IY K OW
NIKOLAI	N IH K OW L AY
NIKOLAS	N IH K AH L AH Z
NIKOLE	N AH K OW L
NILA	N IY L AH
NILDA	N IH L D AH
NILE	N AY L
NILES	N AY L Z
NILS	N IH L Z
NIM	N IH M
NINA	N IY N AH
NINNIE	N IH N AY
NIRA	N IH R AH
NITA	N IY T AH
NOAH	N OW AH
NOBIE	N AA B IY
NOBLE	N OW B AH L
NOE	N OW
NOEL	N OW EH L
NOELIA	N OW EH L Y AH
NOELLE	N OW EH L
NOEMI	N OW AH M IY
NOEMIE	N OW AH M AY
NOHELY	N AA HH L IY
NOLA	N OW L AH
NOLAN	N OW L AH N
NOLEN	N AA L AH N
NOLIA	N OW L Y AH
NOLIE	N AA L IY
NOMA	N OW M AH
NONA	N OW N AA
NONIE	N AA N IY
NORA	N AO R AH
NORAH	N AO R AH
NORBERT	N AO R B ER T
NORBERTO	N AO R B ER T OW
NOREEN	N ER IY N
NORENE	N AH R IY N
NORETA	N AO R AH T AH
NORETTA	N AH R EH T AH
NORINE	N AH R AY N
NORITA	N AH R IY T AH
NORMA	N AO R M AH
NORMAN	N AO R M AH N
NORMAND	N AO R M AH N D
NORRIS	N AO R IH S
NORTH	N AO R TH
NORTON	N AO R T AH N
NORVAL	N AO R V AH L
NORWOOD	N AO R W UH D
NOVA	N OW V AH
NOVELLA	N OW V EH L AH
NUNZIO	N AH N Z IY OW
NYA	N AY AH
NYAH	N AY AH
NYASIA	N AY EY ZH IY AH
NYLA	N IH L AH
NYLAH	N IH L AH
NYREE	N AY R IY IY
OAKLEY	OW K L IY
OBE	OW B
OBED	OW B D
OBIE	OW B IY
OCIE	OW S AY
OCTA	AA K T AH
OCTAVE	AA K T IH V
OCTAVIA	AA K T EY V IY AH
OCTAVIE	AA K T IH V IY
OCTAVIO	AA K T EY V IY OW
OCTAVIUS	AA K T EY V IY AH S
ODA	OW D AH
ODALIS	AA D AH L AH S
ODALYS	AA D AH L AH Z
ODDIE	AA D IY
ODELIA	OW D EH L IY AH
ODELL	OW D EH L
ODESSA	OW D EH S AH
ODETTE	OW D EH T
ODIE	OW D AY
ODILE	OW D AH L
ODIN	OW D AH N
ODIS	OW D AH S
ODUS	OW D AH S
OFELIA	OW F EY L IY AH
OFFIE	AO F IY
OGDEN	AA G D AH N
OKEY	OW K IY
OLA	OW L AH
OLAF	OW L AA F
OLAN	OW L AH N
OLAND	AA L AH N D
OLAR	OW L AH R
OLE	OW L
OLE(2)	OW L EY
OLEN	AA L AH N
OLENA	AA L AH N AH
OLENE	AH L IY N
OLETA	AA L AH T AH
OLEVIA	AH L IY V IY AH
OLEY	OW L IY
OLGA	OW L G AH
OLIE	OW L AY
OLIN	OW L IH N
OLINDA	OW L IY N D AH
OLINE	AH L AY N
OLIVA	OW L IY V AH
OLIVE	AA L AH V
OLIVE(2)	AA L IH V
OLIVER	AA L AH V ER
OLIVER(2)	AA L IH V ER
OLIVIA	OW L IH V IY AH
OLIVINE	AA L AH V IY N
OLLIE	AA L IY
OLLIE(2)	OW L IY
OLOF	OW L AO F
OLYMPIA	OW L IH M P IY AH
OMA	OW M AH
OMAR	OW M AA R
OMARI	AA M AH R IY
OMARION	AH M AE R IY AH N
OMER	OW M ER
OMIE	OW M AY
ONA	AH N AA
ONEAL	OW N IY L
ONEIDA	OW N AY D AH
ONETA	AA N AH T AH
ONEY	OW N IY
ONIE	AO N IY
ONNIE	AO N IY
OPAL	OW P AH L
OPHA	AA F AH
OPHELIA	AH F IY L Y AH
ORA	AO R AH
ORAH	AO R AH
ORAL	AO R AH L
ORALIA	AO R AA L IY AH
ORAN	AO R AA N
ORANGE	AO R AH N JH
ORANGE(2)	AO R IH N JH
ORELIA	AO R EH L IY AH
OREN	AO R AH N
ORENE	AH R IY N
ORIE	OW R IY
ORILLA	AO R IH L AH
ORIN	AO R IH N
ORION	OW R AY AH N
ORION(2)	AO R AY AH N
ORIS	OW R IY Z
ORLA	AO R L AH
ORLAND	AO R L AH N D
ORLANDO	AO R L AE N D OW
ORLENA	AO R L IH N AH
ORLEY	AO R L IY
ORLIN	AO R L AH N
ORLO	AO R L OW
ORMA	AO R M AH
ORPHA	AO R F AH
ORRA	AO R AH
ORREN	AO R AH N
ORRIE	AO R AY
ORRIN	AO R IH N
ORRIS	AO R IH S
ORSON	AO R S AH N
ORVAL	AO R V AH L
ORVEL	AO R V AH L
ORVIL	AO R V AH L
ORVILLE	AO R V IH L
ORVIN	AO R V IH N
ORVIS	AO R V IH S
OSA	AA S AH
OSBALDO	AA S B IY AH L D UW
OSBORN	AO Z B AO R N
OSBORNE	AO Z B AO R N
OSCAR	AO S K ER
OSIE	AA S IY
OSSIE	AA S IY
OSVALDO	AA Z AE L D OW
OSWALD	AO Z W AO L D
OSWALDO	AA S W AA L D OW
OTA	OW T AH
OTELIA	AH T IY L Y AH
OTHA	AH DH AA
OTHEL	AA TH AH L
OTHO	AA TH OW
OTIS	OW T IH S
OTT	AA T
OTTIE	AA T AY
OTTILIA	AA T IH L Y AH
OTTILIE	AA T AH L IY
OTTIS	AA T AH S
OTTO	AA T OW
OUIDA	AW AH D AH
OVA	OW V AH
OVID	AA V AH D
OVILA	AA V AH L AH
OWEN	OW AH N
OWENS	OW AH N Z
OZELL	AA Z AH L
OZELLA	AH Z EH L AH
OZIE	OW Z AY
OZZIE	AA Z IY
PABLO	P AA B L OW
PAGE	P EY JH
PAIGE	P EY JH
PAIRLEE	P EH R L IY
PAISLEY	P EY Z L IY
PAITYN	P EY T AH N
PALLIE	P AE L IY
PALMA	P AA L M AH
PALMER	P AA M ER
PALMER(2)	P AA L M ER
PALOMA	P AA L OW M AH
PAM	P AE M
PAMALA	P AE M AH L AH
PAMELA	P AE M AH L AH
PAMELIA	P AH M IY L Y AH
PAMELLA	P AH M EH L AH
PANDORA	P AE N D AO R AH
PANSY	P AE N Z IY
PAOLA	P EY AH L AH
PARALEE	P EH R AH L IY
PARIS	P EH R IH S
PARIS(2)	P AE R IH S
PARK	P AA R K
PARKER	P AA R K ER
PARLEE	P AA R L IY
PARLEY	P AA R L IY
PARRISH	P EH R IH SH
PARTHENIA	P AA R TH EH N IY AH
PASCAL	P AE S K AE L
PASQUALE	P AA S K W AA L EY
PAT	P AE T
PATE	P EY T
PATIENCE	P EY SH AH N S
PATRIC	P AE T R AH K
PATRICA	P AE T R AH K AH
PATRICE	P AH T R IY S
PATRICIA	P AH T R IH SH AH
PATRICK	P AE T R IH K
PATSY	P AE T S IY
PATTI	P AE T IY
PATTIE	P AE T IY
PATTY	P AE T IY
PAUL	P AO L
PAULA	P AO L AH
PAULETTA	P AA L EH T AH
PAULETTE	P AO L EH T
PAULINA	P AO L IY N AH
PAULINE	P AO L IY N
PAULO	P AO L OW
PAXTON	P AE K S T AH N
PAYTEN	P EY T EH N
PAYTON	P EY T AH N
PEARL	P ER L
PEARLA	P AH R L AH
PEARLE	P ER L
PEARLENE	P AH R L IY N
PEARLEY	P AH R L IY
PEARLIE	P ER L IY
PEARLINE	P ER L AY N
PEARLY	P ER L IY
PEDRO	P EY D R OW
PEGGIE	P EH G IY
PEGGY	P EH G IY
PENELOPE	P AH N EH L AH P IY
PENNI	P EH N IY
PENNIE	P EH N IY
PENNY	P EH N IY
PEPPER	P EH P ER
PERCIVAL	P ER S IH V AH L
PERCY	P ER S IY
PERLA	P ER L AH
PERLEY	P ER L IY
PERMELIA	P AH R M IY L Y AH
PERNELL	P ER N AH L
PERRI	P ER R IY
PERRY	P EH R IY
PERSHING	P ER SH IH NG
PETE	P IY T
PETER	P IY T ER
PETRA	P EH T R AH
PEYTON	P EY T AH N
PHEBE	F IY B IY
PHEOBE	F IY OW B
PHIL	F IH L
PHILIP	F IH L AH P
PHILIP(2)	F IH L IH P
PHILLIP	F IH L IH P
PHILLIS	F IH L IH S
PHILO	F IY L OW
PHILOMENA	F IH L AH M IY N AH
PHILOMENE	F IH L AH M IY N
PHOEBE	F IY B IY
PHOENIX	F IY N IH K S
PHYLICIA	F AH L IH SH IY AH
PHYLIS	F AY L AH S
PHYLISS	F IH L AH S
PHYLLIS	F IH L IH S
PIERCE	P IH R S
PIERRE	P IY EH R
PINK	P IH NG K
PINKEY	P IH N K IY
PINKIE	P IH NG K IY
PINKNEY	P IH NG K N IY
PIPER	P AY P ER
PLEAS	P L IY Z
PLEASANT	P L EH Z AH N T
PLES	P L Z
PLUMA	P L UW M AH
PLUMMER	P L AH M ER
POLK	P OW K
POLK(2)	P OW L K
POLLIE	P OW L IY
POLLY	P AA L IY
PORFIRIO	P AO R F IH R IY OW
PORSCHE	P AO R SH AH
PORSCHE(2)	P AO R SH
PORSHA	P AO R SH AH
PORTER	P AO R T ER
PORTIA	P AO R SH AH
POSEY	P OW Z IY
POWELL	P AA W EH L
PRANAV	P R AE N AH V
PRATT	P R AE T
PRECIOUS	P R EH SH AH S
PRENTICE	P R EH N T IH S
PRENTISS	P R EH N T IH S
PRESLEY	P R EH S L IY
PRESS	P R EH S
PRESTON	P R EH S T AH N
PRICE	P R AY S
PRICILLA	P R AH S IH L AH
PRIMUS	P R AY M AH S
PRINCE	P R IH N S
PRINCESS	P R IH N S EH S
PRISCILA	P R IH S AH L AH
PRISCILLA	P R IH S IH L AH
PROSPER	P R AA S P ER
PRUDENCE	P R UW D AH N S
PRUDIE	P R UW D IY
PRYOR	P R AY ER
PURL	P ER L
QIANA	K AY AH N AH
QUEEN	K W IY N
QUEENIE	K W IY N IY
QUENTIN	K W EH N T IH N
QUIANA	K W AY AH N AH
QUINCY	K W IH N S IY
QUINN	K W IH N
QUINT	K W IH N T
QUINTEN	K W IH N T AH N
QUINTIN	K W IH N T IH N
QUINTON	K W IH N T AO N
RACHAEL	R EY CH AH L
RACHEAL	R AE CH IY AH L
RACHEL	R EY CH AH L
RACHELLE	R AH SH EH L
RACQUEL	R AE K W AH L
RAE	R EY
RAEGAN	R IY G AH N
RAEKWON	R IY K W AH N
RAELYNN	R IY L AH N
RAFAEL	R AA F AY EH L
RAFAELA	R AH F IY L AH
RAFE	R EY F
RAGNA	R AE G N AH
RAHEEM	R AH HH IY M
RAHN	R AE N
RAHSAAN	R AE S EY AH N
RAHUL	R AH HH UW L
RAIDEN	R EY D AH N
RAINA	R EY N AH
RAKEEM	R EY K IY M
RALEIGH	R AO L IY
RALPH	R AE L F
RAMIRO	R AH M IH R OW
RAMON	R AH M OW N
RAMONA	R AH M OW N AH
RAMSEY	R AE M Z IY
RANCE	R AE N S
RAND	R AE N D
RANDAL	R AE N D AH L
RANDALL	R AE N D AH L
RANDEL	R AE N D AH L
RANDELL	R AE N D EH L
RANDI	R AE N D IY
RANDLE	R AE N D AH L
RANDOLF	R AE N D OW L F
RANDOLPH	R AE N D AA L F
RANDY	R AE N D IY
RANSOM	R AE N S AH M
RAOUL	R AA UW L
RAPHAEL	R AA F AY EH L
RAPHAEL(2)	R AA F Y EH L
RAPHAEL(3)	R EY F IY AH L
RAQUAN	R AE K W AH N
RAQUEL	R AH K EH L
RAS	R AE S
RASHAAD	R AE SH AH D
RASHAAN	R AE SH EY AH N
RASHAD	R AH SH AA D
RASHAWN	R AE SH AH N
RASHEED	R AH SH IY D
RASHIDA	R AE SH AH D AH
RAUL	R AO L
RAUL(2)	R AA UW L
RAUL(3)	R AW L
RAVEN	R EY V AH N
RAY	R EY
RAYAN	R EY AH N
RAYBURN	R EY B ER N
RAYFIELD	R EY F IY L D
RAYFORD	R EY F ER D
RAYMON	R EY M AH N
RAYMOND	R EY M AH N D
RAYMUNDO	R EY M AH N D OW
RAYNA	R EY N AH
RAYNARD	R EY N ER D
RAYNE	R EY N
RAYSHAWN	R EY SH AH N
REAGAN	R EY G AH N
REAGAN(2)	R IY G AH N
REANNA	R IY AE N AH
REASON	R IY Z AH N
REATHA	R IY AE TH AH
REBA	R IY B AH
REBECA	R IH B AH K AA
REBECCA	R AH B EH K AH
REBEKAH	R IH B AH K AE
RED	R EH D
REDDEN	R EH D AH N
REDMOND	R EH D M AH N D
REECE	R IY S
REED	R IY D
REESE	R IY S
REFUGIO	R AH F Y UW JH IY OW
REGAN	R IY G AH N
REGENA	R AH JH EH N AH
REGENIA	R AH JH IY N Y AH
REGGIE	R EH JH IY
REGINA	R IH JH IY N AH
REGINAL	R IY JH IH N AH L
REGINALD	R EH JH AH N AH L D
REGIS	R IY JH IH S
REID	R IY D
REILLY	R AY L IY
REINA	R EY IY N AH
REINALDO	R EY N AA L D OW
REINHOLD	R AY N HH OW L T
REINO	R IY AH N OW
RELLA	R EH L AH
REMINGTON	R EH M IH NG T AH N
RENA	R IY N AH
RENADA	R AH N AE D AH
RENAE	R AH N IY
RENALDO	R EH N AA L D OW
RENARD	R IH N AA R D
RENATA	R AH N AA T AH
RENE	R AH N EY
RENEA	R AH N IY
RENEE	R AH N EY
RENITA	R EH N IY T AH
RENNIE	R EH N IY
RENO	R IY N OW
RESSIE	R EY Z IY
RETA	R EH T AH
RETHA	R AH TH AA
RETTA	R IH T AA
RETTIE	R IH T AY
REUBEN	R UW B AH N
REUBIN	R IY Y UW B AH N
REVA	R EY V AH
REX	R EH K S
REXFORD	R EH K S F ER D
REY	R EY
REYES	R EY IH S
REYNA	R EY N AH
REYNALDO	R EY N AA L D OW
REYNOLD	R EH N AH L D
REYNOLDS	R EH N AH L D Z
RHEA	R IY AH
RHETA	R IY T AH
RHETT	R EH T
RHIANNA	R AY AE N AH
RHIANNON	R AY AE N AH N
RHODA	R OW D AH
RHONA	R OW N AH
RHONDA	R AA N D AH
RHYS	R IY S
RIAN	R AY AH N
RIANNA	R AY AE N AH
RICARDO	R IH K AA R D OW
RICCI	R IY CH IY
RICE	R AY S
RICH	R IH CH
RICHARD	R IH CH ER D
RICHELLE	R IH CH AH L
RICHIE	R IH CH IY
RICHMOND	R IH CH M AH N D
RICK	R IH K
RICKEY	R IH K IY
RICKI	R IH K IY
RICKIE	R IH K IY
RICKY	R IH K IY
RICO	R IY K OW
RIDGE	R IH JH
RIGOBERTO	R IH G AH B AH R T OW
RIHANNA	R IY HH AA N AH
RIKKI	R IH K IY
RILEY	R AY L IY
RILLA	R IH L AH
RILLIE	R IH L AY
RINDA	R IH N D AH
RISA	R IY S AH
RISHI	R IH SH IY
RITA	R IY T AH
RITCHIE	R IH CH IY
RIVER	R IH V ER
RIYA	R AY AY AH
ROB	R AA B
ROBB	R AA B
ROBBIE	R AA B IY
ROBBIN	R AA B IH N
ROBBY	R AA B IY
ROBERT	R AA B ER T
ROBERTA	R AH B ER T AH
ROBERTO	R AH B EH R T OW
ROBERTO(2)	R OW B EH R T OW
ROBIN	R AA B AH N
ROBIN(2)	R AA B IH N
ROBLEY	R AA B L IY
ROBT	R AA T
ROBY	R OW B IY
ROBYN	R AA B IH N
ROCCO	R AA K OW
ROCHELLE	R OW SH EH L
ROCHELLE(2)	R AH SH EH L
ROCIO	R OW S IY OW
ROCK	R AA K
ROCKY	R AA K IY
ROD	R AA D
RODDY	R AA D IY
RODERIC	R AA D ER IH K
RODERICK	R AA D R IH K
RODGER	R AA JH ER
RODNEY	R AA D N IY
RODOLFO	R OW D AA L F OW
RODRICK	R AA D R IH K
RODRIGO	R AH D R IY G OW
ROE	R OW
ROEL	R OW AH L
ROENA	R OW AH N AH
ROGELIO	R OW G IY L IY OW
ROGER	R AA JH ER
ROGERS	R AA JH ER Z
ROHAN	R OW AH N
ROLAND	R OW L AH N D
ROLANDA	R OW L AA N D AH
ROLANDO	R OW L AA N D OW
ROLF	R OW L F
ROLL	R OW L
ROLLA	R AA L AH
ROLLAND	R AA L AH N D
ROLLIE	R OW L IY
ROLLIE(2)	R AO L IY
ROLLIN	R OW L IH N
ROLLO	R AA L OW
ROMA	R OW M AH
ROMAINE	R OW M EY N
ROMAN	R OW M AH N
ROME	R OW M
ROMELLO	R AH M EH L OW
ROMEO	R OW M IY OW
ROMIE	R OW M AY
ROMONA	R AA M AH N AH
RON	R AA N
RONA	R OW N AH
RONAL	R OW N AH L
RONALD	R AA N AH L D
RONALDO	R AH N AE L D OW
RONAN	R OW N AH N
RONDA	R AA N D AH
RONDAL	R AA N D AH L
RONI	R OW N IY
RONIN	R OW N IH N
RONNA	R AA N AH
RONNIE	R AA N IY
RONNY	R AA N IY
ROOSEVELT	R OW Z AH V EH L T
ROOSEVELT(2)	R UW Z AH V EH L T
RORY	R AO R IY
ROSA	R OW Z AH
ROSABELLE	R AA S AH B AH L
ROSALEE	R OW S AH L IY
ROSALEE(2)	R OW Z AH L IY
ROSALIA	R OW Z AH L IY AH
ROSALIE	R OW Z AH L IY
ROSALIND	R AA Z AH L IH N D
ROSALINDA	R OW S AA L IY N D AH
ROSALINE	R AA S AH L AY N
ROSALYN	R AA Z AH L IH N
ROSAMOND	R OW Z AH M AH N D
ROSANN	R AA S AH N
ROSANNA	R OW Z AE N AH
ROSANNE	R OW Z AE N
ROSARIA	R OW Z AA R IY AH
ROSARIO	R OW Z AA R IY OW
ROSCO	R AA S OW
ROSCOE	R AA S K OW
ROSE	R OW Z
ROSEANN	R OW S IY N
ROSEANNA	R OW S IY N AH
ROSEANNE	R OW Z AE N
ROSELLA	R OW Z EH L AH
ROSELYN	R AA S AH L AH N
ROSEMARIE	R OW Z M ER IY
ROSEMARY	R OW Z M EH R IY
ROSENA	R AA S AH N AH
ROSENDO	R OW Z AH N D UW
ROSETTA	R OW Z EH T AH
ROSEVELT	R AA S AH V AH L T
ROSEY	R OW Z IY
ROSIA	R OW ZH IY AH
ROSIE	R OW Z IY
ROSINA	R OW Z IY N AH
ROSITA	R OW Z IY T AH
ROSLYN	R AA Z L IH N
ROSS	R AA S
ROSS(2)	R AO S
ROSSIE	R AO S IY
ROSWELL	R AA S W EH L
ROSY	R OW Z IY
ROWAN	R OW AH N
ROWENA	R OW IY N AH
ROWLAND	R OW L AH N D
ROXANA	R AA K S AE N AH
ROXANE	R AA K S EY N
ROXANN	R AA K S AH N
ROXANNA	R AA K S AE N AH
ROXANNE	R AA K S IH N
ROXANNE(2)	R AA K S AE N
ROXIE	R AA K S IY
ROXY	R AA K S IY
ROY	R OY
ROYAL	R OY AH L
ROYCE	R OY S
ROZANNE	R AA Z AH N
ROZELLA	R OW Z EH L AH
RUBE	R UW B
RUBEN	R UW B AH N
RUBI	R UW B IY
RUBIE	R UW B IY
RUBIN	R UW B IH N
RUBY	R UW B IY
RUBYE	R UW B AY
RUDOLF	R UW D AA L F
RUDOLF(2)	R UW D AA F
RUDOLFO	R UW D OW L F OW
RUDOLPH	R UW D AO L F
RUDOLPH(2)	R UW D AO F
RUDY	R UW D IY
RUEBEN	R UW B IY AH N
RUEL	R UW L
RUFFIN	R AH F IH N
RUFFUS	R AH F AH S
RUFUS	R UW F AH S
RUIE	R UW IY
RUPERT	R UW P ER T
RUSH	R AH SH
RUSS	R AH S
RUSSEL	R AH S AH L
RUSSELL	R AH S AH L
RUSTIN	R AH S T IH N
RUSTY	R AH S T IY
RUTH	R UW TH
RUTHA	R AH TH AH
RUTHANN	R UW TH AE N
RUTHANNE	R AH TH AH N
RUTHE	R AH DH
RUTHERFORD	R AH TH ER F ER D
RUTHIE	R UW TH IY
RYAN	R AY AH N
RYANN	R AY AH N
RYDER	R AY D ER
RYKER	R AY K ER
RYLAN	R AY L AH N
RYLAND	R IH L AH N D
RYLEE	R IH L IY
RYLEIGH	R IH L EY
RYLEY	R AY L IY
RYLIE	R IH L AY
RYNE	R AY N
SABASTIAN	S AH B AE S AH N
SABINA	S AH B IY N AH
SABLE	S EY B AH L
SABRA	S AA B R AH
SABRINA	S AH B R IY N AH
SADA	S AA D AH
SADE	S EY D
SADIE	S AE D IY
SADYE	S AE D AY
SAGE	S EY JH
SAIGE	S EY JH
SAINT	S EY N T
SAL	S AE L
SALENA	S AE L AH N AH
SALINA	S AH L IY N AH
SALLIE	S AE L IY
SALLY	S AE L IY
SALMA	S AE L M AH
SALOME	S AH L OW M IY
SALOMON	S AE L AH M AH N
SALVADOR	S AE L V AH D AO R
SALVATORE	S AE L V AH T AO R IY
SALVATORE(2)	S AE L V AH D AO R
SAM	S AE M
SAMANTHA	S AH M AE N TH AH
SAMARA	S AE M ER AH
SAMATHA	S AE M AH TH AH
SAMIE	S EY M IY
SAMIR	S AH M IH R
SAMIR(2)	S AA M IH R
SAMIRA	S AE M AH R AH
SAMMIE	S AE M IY
SAMMY	S AE M IY
SAMPSON	S AE M P S AH N
SAMSON	S AE M S AH N
SAMUAL	S AE M Y AH W AH
SAMUEL	S AE M Y UW L
SANAA	S AH N AA
SANAI	S AE N EY
SANDERS	S AE N D ER Z
SANDI	S AE N D IY
SANDIE	S AE N D IY
SANDRA	S AE N D R AH
SANDY	S AE N D IY
SANFORD	S AE N F ER D
SANIYA	S EY N IY AY AH
SANIYAH	S EY N IY AY AH
SANJUANA	S AE N JH UW W AH N AH
SANJUANITA	S AE N JH AH W AE N AH T AH
SANNIE	S AE N AY
SANTA	S AE N T AH
SANTA(2)	S AE N AH
SANTANA	S AE N T AE N AH
SANTIAGO	S AE N T IY AA G OW
SANTINA	S AE N T AH N AH
SANTINO	S AA N T IY N OW
SANTO	S AE N T OW
SANTOS	S AE N T OW S
SARA	S EH R AH
SARAH	S EH R AH
SARAHI	S AE R AH HH IY
SARAI	S AE R EY
SARIAH	S AE R AY AH
SARINA	S AE R AH N AH
SARITA	S AE R AH T AH
SARRAH	S AE R AH
SASHA	S AE SH AH
SAUL	S AO L
SAUNDRA	S AO N D R AH
SAVANA	S AE V AH N AH
SAVANAH	S AE V AH N AH
SAVANNA	S AH V AE N AH
SAVANNAH	S AH V AE N AH
SAVERIO	S AH V IY R IY OW
SAVILLA	S AH V IH L AH
SAVION	S AE V IY AO N
SAVION(2)	S AE V Y AO N
SAVON	S EY V AO N
SAWYER	S AO Y ER
SAWYER(2)	S OY ER
SCARLET	S K AA R L AH T
SCARLETT	S K AA R L IH T
SCHLEY	SH L EY
SCHUYLER	S K AY L ER
SCOT	S K AA T
SCOTT	S K AA T
SCOTTIE	S K AA T IY
SCOTTY	S K AA T IY
SEABORN	S IY B ER N
SEAMUS	SH EY M AH S
SEAN	SH AO N
SEBASTIAN	S AH B AE S CH AH N
SEBRINA	S EH B R AH N AH
SEDRICK	S EH D R AH K
SELAH	S EH L AH
SELDON	S EH L D AH N
SELENA	S AH L IY N AH
SELENE	S AH L IY N
SELINA	S AH L IY N AH
SELMA	S EH L M AH
SELMER	S EH L M ER
SEMAJ	S EH M AH JH
SENA	S EH N AH
SENECA	S EH N AH K AH
SENORA	S IY N Y AO R AH
SERENA	S AH R IY N AH
SERENITY	S ER EH N AH T IY
SERGIO	S ER JH Y OW
SERINA	S EH R AH N AH
SETH	S EH TH
SEVERO	S EH V AH R OW
SEVERT	S EH V ER T
SEWARD	S UW ER D
SEYMOUR	S IY M AO R
SHAD	SH AE D
SHADE	SH EY D
SHAE	SH IY
SHAFTER	SH AE F T ER
SHAINA	SH EY N AH
SHAKIRA	SH AE K IY R AH
SHALON	SH AE L AH N
SHALONDA	SH AH L AA N D AH
SHAMAR	SH EY M ER
SHAMEKA	SH AE M AH K AH
SHAMIKA	SH AE M AH K AH
SHAN	SH AE N
SHANA	SH AE N AH
SHANA(2)	SH EY N AH
SHANAE	SH AE N IY
SHANDA	SH AE N D AH
SHANDRA	SH AE N D R AH
SHANE	SH EY N
SHANEKA	SH AE N AH K AH
SHANELL	SH AE N AH L
SHANELLE	SH AE N AH L
SHANEQUA	SH AH N EH K W AH
SHANI	SH AE N IY
SHANIA	SH EY N Y AH
SHANICE	SH AE N AH S
SHANIECE	SH EY N IY S
SHANIKA	SH AE N AH K AH
SHANIQUA	SH AH N IH K W AH
SHANITA	SH AE N AH T AH
SHANIYA	SH EY N IY AY AH
SHANNA	SH AE N AH
SHANNAN	SH AE N AH N
SHANNEN	SH AE N AH N
SHANNON	SH AE N AH N
SHANON	SH AE N AH N
SHANTA	SH AE N T AH
SHANTE	SH AE N T
SHANTEL	SH AE N T AH L
SHANTELL	SH AE N T AH L
SHAQUAN	SH AE K W AH N
SHAQUANA	SH AE K W AH N AH
SHAQUILLE	SH AH K IY L
SHAQUITA	SH AE K W AH T AH
SHARA	SH AA R AH
SHARDAE	SH AA R D IY
SHARDAY	SH AA R D EY IY
SHARDE	SH AA R D
SHAREE	SH EH R IY
SHAREN	SH EH R AH N
SHARI	SH AA R IY
SHARIF	SH ER IY F
SHARITA	SH AE R AH T AH
SHARLA	SH AA R L AH
SHARLEEN	SH AA R L IY N
SHARLENE	SH AA R L IY N
SHARMAN	SH AA R M AH N
SHARON	SH AE R AH N
SHARON(2)	SH EH R AH N
SHARON(3)	SH AH R OW N
SHARONDA	SH AH R AA N D AH
SHARRON	SH AE R AH N
SHARYL	SH AA R AH L
SHARYN	SH AE R AH N
SHASTA	SH AE S T AH
SHATARA	SH AE T AH R AH
SHAUN	SH AO N
SHAUNA	SH AO N AH
SHAUNNA	SH AO N AH
SHAVON	SH AE V AH N
SHAVONNE	SH AE V AH N
SHAWANDA	SH AO AE N D AH
SHAWN	SH AO N
SHAWNA	SH AO N AH
SHAWNDA	SH AO N D AH
SHAWNEE	SH AO N IY
SHAWNNA	SH AO N AH
SHAWNTE	SH AO N T
SHAY	SH EY
SHAYLA	SH EY L AH
SHAYLEE	SH EY L IY IY
SHAYNA	SH EY N AH
SHAYNE	SH EY N
SHEA	SH EY
SHEDRICK	SH EH D R IH K
SHEENA	SH IY N AH
SHEILA	SH IY L AH
SHEILAH	SH IY L AH
SHELBA	SH EH L B AH
SHELBI	SH EH L B IY
SHELBIE	SH EH L B AY
SHELBY	SH EH L B IY
SHELDON	SH EH L D AH N
SHELIA	SH IH L Y AH
SHELLEY	SH EH L IY
SHELLI	SH EH L IY
SHELLIE	SH EH L IY
SHELLY	SH EH L IY
SHELTON	SH EH L T AH N
SHELVA	SH EH L V AH
SHELVIA	SH EH L V IY AH
SHELVIE	SH EH L V IY
SHEMAR	SH IY M AH R
SHENA	SH IY N AH
SHENNA	SH EH N AH
SHEP	SH EH P
SHEPHERD	SH EH P ER D
SHEREE	SH ER IY
SHERI	SH EH R IY
SHERIDAN	SH EH R IH D AH N
SHERIE	SH IY R AY
SHERILYN	SH EH R AH L AH N
SHERITA	SH EH R AH T AH
SHERLYN	SH AH R L AH N
SHERMAN	SH ER M AH N
SHERON	SH EH R AH N
SHERREE	SH EH R IY IY
SHERRI	SH EH R IY
SHERRIE	SH EH R IY
SHERRILL	SH EH R IH L
SHERRON	SH EH R AH N
SHERRY	SH EH R IY
SHERRYL	SH EH R AH L
SHERWIN	SH ER W IH N
SHERWOOD	SH ER W UH D
SHERYL	SH EH R AH L
SHERYLL	SH EH R AH L
SHEYLA	SH EY L AH
SHIANNE	SH AY AH N
SHIELA	SH AY L AH
SHILOH	SH AY L OW
SHIRA	SH IH R AH
SHIRL	SH ER L
SHIRLEE	SH ER L IY
SHIRLEEN	SH ER L IY N
SHIRLENE	SH ER L IY N
SHIRLEY	SH ER L IY
SHIRLEYANN	SH AH R L EY AH N
SHIRLIE	SH ER L IY
SHOJI	SH OW JH IY
SHON	SH AA N
SHONA	SH OW N AH
SHONDA	SH AA N D AH
SHONNA	SH AA N AH
SHREYA	SH R EY AH
SHYANN	SH AY AH N
SHYANNE	SH AY AH N
SHYHEIM	SH AH HH IY M
SHYLA	SH IH L AH
SIBBIE	S IH B IY
SIBYL	S IH B AH L
SID	S IH D
SIDDIE	S IH D AY
SIDNEY	S IH D N IY
SIE	S IY
SIENA	S IY N AH
SIENNA	S IY EH N AH
SIERRA	S IY EH R AH
SIGMUND	S IH G M AH N D
SIGNA	S IH G N AH
SIGNE	S IH N
SIGRID	S IH G R IH D
SIGURD	S IH G ER D
SILAS	S AY L AH S
SILVER	S IH L V ER
SILVESTER	S IH L V EH S T ER
SILVIA	S IH L V IY AH
SILVIO	S IH L V IY OW
SIM	S IH M
SIMEON	S IH M IY AH N
SIMMIE	S IH M AY
SIMON	S AY M AH N
SIMONA	S IH M OW N AH
SIMONE	S IH M OW N
SIMPSON	S IH M P S AH N
SINA	S IH N AH
SINCERE	S IH N S IH R
SINDA	S IH N D AH
SING	S IH NG
SIOBHAN	SH AW B AA N
SISTER	S IH S T ER
SKIP	S K IH P
SKY	S K AY
SKYE	S K AY
SKYLA	S K IH L AH
SKYLAR	S K AY L AH R
SKYLER	S K AY L AH R
SLADE	S L EY D
SLOANE	S L OW N
SMITH	S M IH TH
SOCORRO	S AH K AO R OW
SOFIA	S OW F IY AH
SOL	S AA L
SOL(2)	S OW L
SOLEDAD	S OW L D AE D
SOLOMAN	S OW L OW M AE N
SOLOMON	S AA L AH M AH N
SOLON	S OW L AH N
SOMER	S AH M ER
SOMMER	S AH M ER
SON	S AH N
SONDRA	S AA N D R AH
SONIA	S OW N Y AA
SONJA	S OW N Y AA
SONJI	S AO N JH IY
SONNY	S AH N IY
SONYA	S OW N Y AH
SOPHIA	S OW F IY AH
SOPHIE	S OW F IY
SOPHRONIA	S OW F R OW N IY AH
SOREN	S OW R AH N
SPENCER	S P EH N S ER
SPENSER	S P EH N S ER
SPRING	S P R IH NG
SPRING(2)	S P ER IH NG
SPURGEON	S P ER JH IH N
SQUIRE	S K W AY R
STACEY	S T EY S IY
STACI	S T AE S IY
STACIA	S T AA CH AH
STACIE	S T EY S IY
STACY	S T EY S IY
STAFFORD	S T AE F ER D
STAN	S T AE N
STANFORD	S T AE N F ER D
STANISLAUS	S T AH N IH Z L EY AH S
STANLEY	S T AE N L IY
STANTON	S T AE N T AH N
STAR	S T AA R
STARLA	S T AA R L AH
STARLING	S T AA R L IH NG
STARR	S T AA R
STASIA	S T EY ZH IY AH
STEFAN	S T EH F AA N
STEFANI	S T EH F AH N IY
STEFANIE	S T EH F AH N IY
STELLA	S T EH L AH
STEPHAINE	S T AH F EY N
STEPHAN	S T EH F AH N
STEPHANI	S T EH F AH N IY
STEPHANIA	S T IH F AE N IY AH
STEPHANIE	S T EH F AH N IY
STEPHANY	S T EH F AH N IY
STEPHEN	S T IY V AH N
STEPHENIE	S T EH P HH EH N IY
STEPHON	S T EH F AH N
STERLING	S T ER L IH NG
STETSON	S T EH T S AH N
STEVAN	S T IY V AH N
STEVE	S T IY V
STEVEN	S T IY V AH N
STEVIE	S T IY V IY
STEWARD	S T UW ER D
STEWART	S T UW ER T
STONE	S T OW N
STONEWALL	S T OW N W AO L
STONEY	S T OW N IY
STORM	S T AO R M
STORMY	S T AO R M IY
STUART	S T UW ER T
STUART(2)	S T Y UW ER T
STUART(3)	S T AO R T
SUDIE	S UW D AY
SUE	S UW
SUELLEN	S UW EH L AH N
SULA	S UW L AH
SULLIVAN	S AH L AH V AH N
SULLIVAN(2)	S AH L IH V AH N
SUMMER	S AH M ER
SUMNER	S AH M N ER
SUNDAY	S AH N D EY
SUNDAY(2)	S AH N D IY
SUNNY	S AH N IY
SUNSHINE	S AH N SH AY N
SUSAN	S UW Z AH N
SUSANA	S UW S AA N AH
SUSANN	S UW Z AE N
SUSANNA	S UW Z AE N AH
SUSANNAH	S UW S AE N AH
SUSANNE	S UW Z AE N
SUSIE	S UW Z IY
SUSSIE	S AH S AY
SUZAN	S UW Z AH N
SUZANN	S UW Z AH N
SUZANNA	S UW Z AE N AH
SUZANNE	S UW Z AE N
SUZETTE	S UW Z EH T
SUZIE	S AH Z IY
SUZY	S UW Z IY
SYBIL	S IH B IH L
SYBILLA	S IH B IH L AH
SYBLE	S AY B AH L
SYDELL	S AY D EH L
SYDNEE	S IH D N IY IY
SYDNEY	S IH D N IY
SYDNI	S IH D N IY
SYDNIE	S IH D N AY
SYED	S AY D
SYLVA	S IH L V AH
SYLVAN	S IH L V AH N
SYLVANIA	S IH L V EY N IY AH
SYLVANUS	S IH L V AH N IH S
SYLVESTER	S IH L V EH S T ER
SYLVIA	S IH L V IY AH
SYMONE	S AH M OW N
SYREETA	S AH R IY T AH
TAB	T AE B
TABATHA	T AE B AH TH AH
TABETHA	T AE B AH TH AH
TABITHA	T AE B IH TH AH
TAD	T AE D
TAFT	T AE F T
TAHJ	T AE JH
TAI	T AY
TAINA	T EY N AH
TAJ	T AA ZH
TAJA	T AE JH AH
TAKISHA	T AE K AH SH AH
TAL	T AA L
TALAN	T EY L AH N
TALEN	T EY L AH N
TALIA	T EY L Y AH
TALIYAH	T EY L IY AY AH
TALLIE	T AO L IY
TALMADGE	T AE L M AE JH
TALMAGE	T AE L M IH JH
TALON	T AE L AH N
TAMALA	T AE M AH L AH
TAMARA	T AH M AA R AH
TAMATHA	T AE M AH TH AH
TAMBRA	T AE M B R AH
TAMEKA	T AE M AH K AH
TAMEKIA	T AH M IY K IY AH
TAMELA	T AE M AH L AH
TAMERA	T AE M AH R AH
TAMI	T AE M IY
TAMIA	T EY M IY AH
TAMICA	T AE M AH K AH
TAMIE	T EY M IY
TAMIKA	T AE M AH K AH
TAMIKO	T AE M AH K OW
TAMISHA	T AE M AH SH AH
TAMMI	T AE M IY
TAMMIE	T AE M IY
TAMMY	T AE M IY
TAMRA	T AE M R AH
TAMYA	T AE M AY AH
TANA	T AE N AH
TANDY	T AE N D IY
TANESHA	T AE N AH SH AH
TANGELA	T AE N JH AH L AH
TANIA	T AA N Y AH
TANIKA	T AE N AH K AH
TANISHA	T AE N AH SH AH
TANIYA	T EY N IY AY AH
TANIYAH	T EY N IY AY AH
TANJA	T AE N JH AH
TANNER	T AE N ER
TANYA	T AA N Y AH
TARA	T EH R AH
TARA(2)	T AA R AH
TARAH	T AE R AH
TARI	T AE R IY
TARIK	T AE R AH K
TARIQ	T AA R IY K
TARSHA	T AA R SH AH
TARYN	T AE R AH N
TASHA	T AE SH AH
TASHINA	T AE SH AH N AH
TASIA	T EY ZH IY AH
TATE	T EY T
TATIA	T EY SH IY AH
TATIANA	T AE T IY AE N AA
TATIANA(2)	T AE T Y AA N AA
TATIANNA	T EY T IY AE N AH
TATSUO	T AE T S UW W OW
TATUM	T EY T AH M
TATYANA	T AA T Y AA N AA
TATYANNA	T AE T AY AE N AH
TAUREAN	T AO R IY AH N
TAURUS	T AO R AH S
TAVARES	T AA V AA R EH S
TAVARIS	T AE V AH R AH S
TAVIAN	T EY V IY AH N
TAVION	T EY V IY AH N
TAVON	T AE V AH N
TAWANA	T AA W AA N AH
TAWANDA	T AO AE N D AH
TAWANNA	T AO AE N AH
TAWNY	T AA N IY
TAWNYA	T AO N AY AH
TAYA	T EY AH
TAYLA	T EY L AH
TAYLER	T EY L ER
TAYLOR	T EY L ER
TAYSHAUN	T EY SH AH N
TEA	T IY
TEAGAN	T IY AH JH AH N
TED	T EH D
TEDDIE	T EH D IY
TEDDY	T EH D IY
TEELA	T IY L AH
TEENA	T IY N AH
TEGAN	T IY G AH N
TELLA	T EH L AH
TELLY	T EH L IY
TEMPIE	T EH M P AY
TENA	T EH N AH
TENIKA	T EH N AH K AH
TENISHA	T EH N AH SH AH
TENNESSEE	T EH N AH S IY
TENNIE	T EH N IY
TENNILLE	T EH N AH L
TERA	T EH R AH
TERANCE	T IY R AH N S
TERELL	T EH R AH L
TERENCE	T EH R AH N S
TERESA	T ER IY S AH
TERESA(2)	T ER EY S AH
TERESE	T EH R IY Z
TERESSA	T ER EH S AH
TERI	T EH R IY
TERRA	T EH R AA
TERRANCE	T EH R AH N S
TERRELL	T EH R AH L
TERRENCE	T EH R AH N S
TERRI	T EH R IY
TERRIE	T EH R IY
TERRILL	T EH R AH L
TERRY	T EH R IY
TESS	T EH S
TESSA	T EH S AH
TESSIE	T EH S IY
TEVIN	T EH V AH N
TEX	T EH K S
TEXANNA	T EH K S AE N AH
TEXAS	T EH K S AH S
TEXIE	T EH K S AY
THAD	TH AE D
THADDEUS	TH AE D IY AH S
THALIA	TH EY L Y AH
THEA	TH IY AH
THEADORE	TH IY D AH R
THEDA	TH IY D AA
THEDORE	DH AH D OW R
THEKLA	TH EH K L AH
THELMA	TH EH L M AH
THEO	TH IY OW
THEODIS	TH IY AH D AH S
THEODOCIA	TH IY AH D OW SH IY AH
THEODORA	TH IY AH D AO R AH
THEODORE	TH IY AH D AO R
THEODOSIA	TH IY AH D OW ZH IY AH
THEOLA	TH IY AH L AH
THEOPHILE	TH IY AH F AY L
THERESA	T ER IY S AH
THERESA(2)	T ER EY S AH
THERESE	TH EH R IY S
THERESIA	TH AH R IY ZH IY AH
THERMAN	TH AH R M AH N
THERON	TH EH R AH N
THETA	TH EY T AH
THOMAS	T AA M AH S
THOMASINA	TH OW M AA S IY N AH
THOMASINA(2)	T AA M AA S IY N AH
THOMPSON	T AA M P S AH N
THOMPSON(2)	T AA M S AH N
THOR	TH AO R
THORA	TH AO R AH
THORNTON	TH AO R N T AH N
THORWALD	TH AO R W AH L D
THOS	DH OW Z
THRESA	TH R EH S AH
THURLOW	TH ER L OW
THURMAN	TH ER M AH N
THURSA	TH AH R S AH
THURSTON	TH ER S T AH N
THYRA	TH AY R AH
TIA	T IY AH
TIANA	T AY AH N AH
TIANNA	T AY AE N AH
TIARA	T IY AA R AH
TIARRA	T AY AE R AH
TIERA	T IY R AH
TIERRA	T IY R AH
TIESHA	T IY SH AH
TIFFANI	T IH F AH N IY
TIFFANIE	T IH F EY N AY
TIFFANY	T IH F AH N IY
TILDA	T IH L D AH
TILDEN	T IH L D AH N
TILLA	T IH L AH
TILLIE	T IH L IY
TILLMAN	T IH L M AH N
TILMAN	T IH L M AH N
TIM	T IH M
TIMMIE	T IH M IY
TIMMOTHY	T IH M AH TH IY
TIMMY	T IH M IY
TIMOTHY	T IH M AH TH IY
TINA	T IY N AH
TINEY	T AY N IY
TINIE	T AY N IY
TINNIE	T IH N IY
TINY	T AY N IY
TISA	T IH S AH
TISHA	T IH SH AH
TISHIE	T IH SH AY
TITO	T IY T OW
TITUS	T AY T AH S
TOBE	T OW B
TOBI	T OW B IY
TOBIAS	T AH B AY AH S
TOBIE	T OW B IY
TOBIN	T OW B IH N
TOBY	T OW B IY
TOCCARA	T AA K AH R AH
TOD	T AA D
TODD	T AA D
TOIVO	T OY V OW
TOLBERT	T OW L B ER T
TOLLIE	T OW L IY
TOM	T AA M
TOMA	T OW M AH
TOMAS	T OW M AA S
TOMASA	T AA M AH S AH
TOMEKA	T AA M AH K AH
TOMIE	T OW M IY
TOMIKA	T AA M AH K AH
TOMMIE	T AA M IY
TOMMY	T AA M IY
TONDA	T AA N D AH
TONEY	T OW N IY
TONI	T OW N IY
TONIA	T OW N IY AH
TONJA	T AA N JH AH
TONY	T OW N IY
TONYA	T AA N Y AH
TOREY	T AO R IY
TORI	T AO R IY
TORIANO	T AH R IY AH N OW
TORIE	T AO R IY
TORRANCE	T AO R AH N S
TORRENCE	T AO R AH N S
TORREY	T AO R IY
TORRIE	T AO R IY
TORRY	T AO R IY
TORY	T AO R IY
TOSHA	T AA SH AH
TOSHIKO	T AA SH AH K OW
TOSHIO	T OW SH IY OW
TOWANDA	T OW AE N D AH
TOY	T OY
TOYA	T OY AH
TRACE	T R EY S
TRACEE	T R EY S IY
TRACEY	T R EY S IY
TRACI	T R EY S IY
TRACIE	T R EY S IY
TRACY	T R EY S IY
TRAE	T R IY
TRAVIS	T R AE V IH S
TRAVON	T R AE V AH N
TRAYVON	T R EY V AH N
TRE	T R EY
TREASURE	T R EH ZH ER
TREENA	T R IY N AH
TREMAINE	T R IH M EY N
TREMAYNE	T R EH M EY N
TRENA	T R EH N AH
TRENT	T R EH N T
TRENTEN	T R EH N T AH N
TRENTON	T R EH N T AH N
TRESA	T R EH S AH
TRESSA	T R EH S AH
TRESSIE	T R EH S AY
TREVA	T R EH V AH
TREVER	T R IY V AH R
TREVIN	T R EH V AH N
TREVION	T R IY V IY AH N
TREVON	T R EH V AH N
TREVOR	T R EH V ER
TREY	T R EY
TREYTON	T R EY T AH N
TREYVON	T R EY V AH N
TRICIA	T R IH SH AH
TRILBY	T R IH L B IY
TRINA	T R IH N AH
TRINIDAD	T R IH N IH D AE D
TRINITY	T R IH N AH T IY
TRINITY(2)	T R IH N IH T IY
TRIPP	T R IH P
TRISH	T R IH SH
TRISHA	T R IH SH AH
TRISTA	T R IH S T AH
TRISTAN	T R IH S T AE N
TRISTEN	T R AY Z T EH N
TRISTIAN	T R IH S AH N
TRISTIN	T R AY Z T IH N
TRISTON	T R AY Z T AH N
TROY	T R OY
TRUDI	T R UW D IY
TRUDIE	T R UW D IY
TRUDY	T R UW D IY
TRUE	T R UW
TRULA	T R UW L AH
TRUMAINE	T R UW M EY N
TRUMAN	T R UW M AH N
TRYSTAN	T R AY Z T AE N
TUAN	T Y UW AH N
TUCKER	T AH K ER
TULA	T UW L AH
TURNER	T ER N ER
TWILA	T W IH L AH
TWYLA	T W AY L AH
TY	T AY
TYE	T AY
TYESHA	T AY AH SH AH
TYLER	T AY L ER
TYLOR	T AY L AH R
TYQUAN	T IH K W AH N
TYRA	T AY R AH
TYREE	T AY R IY
TYREEK	T AH R IY K
TYREESE	T AH R IY Z
TYREK	T IH R AH K
TYREKE	T AH R IY K
TYREL	T IH R AH L
TYRELL	T AY R AH L
TYRESE	T AH R IY Z
TYRIK	T IH R AH K
TYRIN	T IH R AH N
TYRIQ	T IH R AH K
TYRIQUE	T IH R AH K
TYRON	T IH R AH N
TYRONE	T AY R OW N
TYRUS	T AY R AH S
TYSHAWN	T IH SH AH N
TYSON	T AY S AH N
ULA	Y UW L AH
ULISES	Y UW L AY Z AH Z
ULYSSES	Y UW L IH S IY Z
UNA	UW N AH
UNIQUE	Y UW N IY K
UNKNOWN	AH N N OW N
UNNAMED	AH N N EY M D
URA	Y UH R AH
URBAN	ER B AH N
URIAH	Y UH R AY AH
URIEL	Y AH R IY L
URIJAH	Y UH R AH JH AH
URSULA	ER S AH L AH
VADA	V AE D AH
VAL	V AE L
VALARIE	V EY L ER IY
VALENCIA	V AH L EH N S IY AH
VALENTIN	V AA L EH N T IY N
VALENTINA	V AA L EH N T IY N AH
VALENTINE	V AE L AH N T AY N
VALENTINO	V AE L AH N T IY N OW
VALERIA	V AH L IY R IY AH
VALERIE	V AE L ER IY
VALERY	V AE L ER IY
VALINDA	V AH L IH N D AH
VALLIE	V AO L IY
VALORIE	V AE L ER IY
VAN	V AE N
VANCE	V AE N S
VANDER	V AE N D ER
VANESA	V AE N AH S AH
VANESSA	V AH N EH S AH
VANNIE	V AE N IY
VARA	V AA R AH
VASHON	V AE SH AH N
VASHTI	V AE SH T IY
VASSIE	V AE S AY
VAUGHN	V AO N
VEDA	V EY D AH
VELA	V EH L AH
VELDA	V EH L D AH
VELIA	V IY L Y AH
VELLA	V EH L AH
VELMA	V EH L M AH
VELVA	V EH L V AH
VELVET	V EH L V AH T
VENA	V IY N AH
VENESSA	V AH N EH S AH
VENICE	V EH N AH S
VENICE(2)	V EH N IH S
VENIE	V IY N AY
VENITA	V EH N IY T AH
VENNIE	V EH N AY
VENUS	V IY N AH S
VEOLA	V IY AH L AH
VERA	V EH R AH
VERDA	V EH R D AH
VERDELL	V AH R D AH L
VERDIE	V ER D IY
VERE	V IH R
VERENA	V ER EY N AH
VERGIE	V ER JH IY
VERGIL	V ER JH AH L
VERL	V AH R L
VERLA	V EH R L AH
VERLE	V AH R L
VERLENE	V AH R L IY N
VERLIE	V AH R L AY
VERLIN	V AH R L AH N
VERLON	V AH R L AH N
VERLYN	V AH R L AH N
VERN	V ER N
VERNA	V ER N AH
VERNAL	V ER N AH L
VERNE	V ER N
VERNELL	V AH R N AH L
VERNELLE	V AH R N AH L
VERNER	V ER N ER
VERNETTA	V AH R N EH T AH
VERNIA	V AH R N IY AH
VERNICE	V AH R N AH S
VERNIE	V AH R N AY
VERNITA	V ER N IY T AH
VERNON	V ER N AH N
VERONA	V ER OW N AH
VERONICA	V ER AA N IH K AH
VERSA	V ER S AH
VERSIE	V ER S IY
VERTIE	V AH R T AY
VESSIE	V EH S AY
VESTA	V EH S T AH
VESTER	V EH S T ER
VETA	V EH T AH
VEVA	V EH V AH
VIC	V IH K
VICENTE	V IY CH EH N T IY
VICIE	V AY S IY
VICK	V IH K
VICKEY	V IH K IY
VICKI	V IH K IY
VICKIE	V IH K IY
VICKY	V IH K IY
VICTOR	V IH K T ER
VICTORIA	V IH K T AO R IY AH
VICTORIANO	V IH K T AH R IY AH N OW
VICTORINE	V IY K T AO R IY N IY
VICTORY	V IH K T AH R IY
VICY	V AY S IY
VIDA	V AY D AH
VIDAL	V AY D AE L
VIKKI	V IH K IY
VILLA	V IH L AH
VILMA	V IH L M AH
VINA	V IY N AH
VINCE	V IH N S
VINCENT	V IH N S EH N T
VINCENT(2)	V IH N S IH N T
VINCENZA	V IH N S EH N Z AH
VINCENZO	V IH N S EH N Z OW
VINEY	V AY N IY
VINIE	V AY N IY
VINNIE	V IH N IY
VINSON	V IH N S AH N
VINTON	V IH N T AH N
VIOLA	V AY OW L AH
VIOLA(2)	V IY OW L AH
VIOLET	V AY AH L IH T
VIOLETA	V IY OW L EH T AH
VIOLETA(2)	V AY OW L EH T AH
VIOLETTA	V IY OW L EH T AH
VIOLETTE	V IY OW L EH T
VIRA	V IH R AH
VIRDIE	V AH R D AY
VIRGE	V ER JH
VIRGEL	V AH R JH AH L
VIRGIA	V AH R JH IY AH
VIRGIE	V ER G IY
VIRGIL	V ER JH AH L
VIRGINIA	V ER JH IH N Y AH
VIRGLE	V AH R G AH L
VIRIDIANA	V IH R AH D IY AH N AH
VITA	V AY T AH
VITO	V IY T OW
VIVA	V IY V AH
VIVIAN	V IH V IY AH N
VIVIANA	V IH V IY AE N AH
VIVIEN	V IH V IY AH N
VIVIENNE	V IH V IY AH N
VLASTA	V L AE S T AH
VOLLIE	V AA L AY
VOLNEY	V OW L N IY
VON	V AO N
VONDA	V AA N D AH
VONETTA	V AH N EH T AH
VONNIE	V AA N IY
WADE	W EY D
WAINO	W EY N OW
WALDEMAR	V AA L D AH M AA R
WALDO	W AA L D OW
WALDO(2)	W AO L D OW
WALKER	W AO K ER
WALLACE	W AO L AH S
WALLACE(2)	W AO L IH S
WALLY	W AO L IY
WALLY(2)	W EY L IY
WALT	W AO L T
WALTER	W AO L T ER
WALTON	W AO L T AH N
WANDA	W AA N D AH
WANETA	W AA N AH T AH
WANITA	W AA N AH T AH
WARD	W AO R D
WARDELL	W AO R D EH L
WARNER	W AO R N ER
WARREN	W AO R AH N
WASH	W AA SH
WASHINGTON	W AA SH IH NG T AH N
WASHINGTON(2)	W AO SH IH NG T AH N
WATSON	W AA T S AH N
WATT	W AA T
WAVA	W AA V AH
WAVERLY	W EY V ER L IY
WAYDE	W EY D
WAYLAND	W EY L AH N D
WAYLON	W EY L AA N
WAYMAN	W EY M AH N
WAYMON	W EY M AH N
WAYNE	W EY N
WEAVER	W IY V ER
WEBB	W EH B
WEBSTER	W EH B S T ER
WELDON	W EH L D AH N
WELLINGTON	W EH L IH NG T AH N
WELLS	W EH L Z
WELTON	W EH L T AH N
WENDE	W EH N D
WENDEL	W EH N D AH L
WENDELL	W EH N D AH L
WENDI	W EH N D IY
WENDY	W EH N D IY
WENZEL	W EH N Z AH L
WERNER	W ER N ER
WES	W EH S
WESLEY	W EH S L IY
WESS	W EH S
WEST	W EH S T
WESTLEY	W EH S T L IY
WESTON	W EH S T AH N
WHEELER	W IY L ER
WHEELER(2)	HH W IY L ER
WHIT	W IH T
WHIT(2)	HH W IH T
WHITLEY	W IH T L IY
WHITLEY(2)	HH W IH T L IY
WHITNEY	W IH T N IY
WHITNEY(2)	HH W IH T N IY
WILBER	W IH L B ER
WILBERT	W IH L B ER T
WILBUR	W IH L B ER
WILBURN	W IH L B ER N
WILDA	W IH L D AH
WILEY	W AY L IY
WILFORD	W IH L F ER D
WILFRED	W IH L F R IH D
WILFREDO	W IH L F EY D OW
WILFRID	W IH L F R IH D
WILHELM	W IH L HH EH L M
WILHELMINA	W IH L HH EH L M IY N AA
WILHELMINE	W IH L HH IH L M IH N
WILIAM	W IH L IY AH M
WILKIE	W IH L K IY
WILL	W IH L
WILL(2)	W AH L
WILLA	W IH L AH
WILLAIM	W IH L EY M
WILLAM	W IH L AH M
WILLARD	W IH L ER D
WILLENE	W IH L IY N
WILLIA	W IH L IY AH
WILLIAM	W IH L Y AH M
WILLIAMS	W IH L Y AH M Z
WILLIAN	W IH L IY AH N
WILLIARD	W IH L Y AA R D
WILLIE	W IH L IY
WILLIEMAE	W IH L AH M IY
WILLIS	W IH L IH S
WILLODEAN	W IH L OW D IY AH N
WILLOW	W IH L OW
WILLY	W IH L IY
WILMA	W IH L M AH
WILMER	W IH L M ER
WILSON	W IH L S AH N
WILTON	W IH L T AH N
WINDELL	W IH N D AH L
WINDY	W IH N D IY
WINDY(2)	W AY N D IY
WINFIELD	W IH N F IY L D
WINFORD	W IH N F ER D
WINFRED	W IH N F R IH D
WING	W IH NG
WINIFRED	W IH N IH F R IH D
WINNIE	W IH N IY
WINNIFRED	W IH N AH F AH R D
WINONA	W IH N AH N AH
WINSTON	W IH N S T AH N
WINTER	W IH N T ER
WINTHROP	W IH N TH R AH P
WINTON	W IH N T AH N
WIRT	W ER T
WM	W IH L Y AH M
WM(2)	D AH B AH Y UW EH M
WONG	W AO NG
WOOD	W UH D
WOODIE	W UH D IY
WOODROE	W UH D R OW
WOODROW	W UH D R OW
WOODSON	W UH D S AH N
WOODY	W UH D IY
WORLEY	W ER L IY
WORTH	W ER TH
WRIGHT	R AY T
WYATT	W AY AH T
WYLIE	W AY L IY
WYMAN	W AY M AH N
WYNONA	W AY N OW N AH
WYNONA(2)	HH W AY N OW N AH
XANDER	Z AE N D AH R
XAVIER	Z EY V Y ER
XENA	Z IY N AH
XIMENA	Z IH M AH N AH
XIOMARA	Z AY AA M AH R AH
XZAVIER	Z AE V AY AH R
YAAKOV	Y AA K AH V
YADIEL	Y EY D IY L
YADIRA	Y AE D AH R AH
YAEL	Y IY L
YAHAIRA	Y AH HH AE AH R AH
YAHIR	Y AE HH AH R
YAIR	Y AE AH R
YAJAIRA	Y AH JH AE AH R AH
YAMILET	Y AE M AH L AH T
YAMILEX	Y AE M AH L AH K S
YANCY	Y AE N S IY
YANDEL	Y AE N D AH L
YARELI	Y AE R AH L IY
YARETZI	Y AH R EH T S IY
YARITZA	Y AH R IH T S AH
YASMEEN	Y AE Z M IY AH N
YASMIN	Y AE Z M IH N
YASMINE	Y AE Z M IH N
YAZMIN	Y AE Z M AH N
YEE	Y IY
YEHUDA	Y AH HH UW D AH
YESENIA	Y AH S IY N Y AH
YESSENIA	Y EH S IY N Y AH
YETTA	Y EH T AH
YOEL	Y OW AH L
YOLANDA	Y OW L AA N D AH
YOLONDA	Y AH L AA N D AH
YORK	Y AO R K
YOSEF	Y OW S AH F
YOSELIN	Y AA S AH L AH N
YOSHIKO	Y AA SH AH K OW
YOSHIO	Y OW SH IY OW
YOUNG	Y AH NG
YULIANA	Y UW L IY AH N AH
YULISA	Y UW L AH S AH
YULISSA	Y UW L IH S AH
YUREM	Y UH R AH M
YURIDIA	Y AH R IH D IY AH
YUSUF	Y UW S AH F
YVETTE	IH V EH T
YVONNE	IH V AA N
ZACHARIAH	Z AE K ER AY AH
ZACHARY	Z AE K ER IY
ZACHERY	Z AE K ER IY
ZACK	Z AE K
ZACKARY	Z AE K AH R IY
ZACKERY	Z AE K ER IY
ZADA	Z AA D AH
ZADIE	Z EY D AY
ZAID	Z EY D
ZAIDA	Z EY D AH
ZAIDEN	Z EY D AH N
ZAIN	Z EY N
ZAIRE	Z AY IH R
ZAKARY	Z EY K AH R IY
ZANA	Z AE N AH
ZANDER	Z AE N D ER
ZANDRA	Z AE N D R AH
ZANE	Z EY N
ZANIYAH	Z EY N IY AY AH
ZARA	Z AE R AH
ZARIA	Z AA R IY AH
ZARIAH	Z AE R AY AH
ZAVIER	Z AE V AY AH R
ZAYDEN	Z EY D AH N
ZAYNE	Z EY N
ZEB	Z EH B
ZEBULON	Z IY B AH L AH N
ZECHARIAH	Z AH CH AE R AY AH
ZED	Z EH D
ZEKE	Z IY K
ZELA	Z EH L AH
ZELDA	Z EH L D AH
ZELIA	Z EH L IY AH
ZELLA	Z EH L AH
ZELMA	Z EH L M AH
ZELPHA	Z EH L F AH
ZENA	Z IY N AH
ZENAS	Z IY N AH Z
ZENO	Z EY N OW
ZENOBIA	Z AH N OW B IY AH
ZETA	Z EY T AH
ZETTA	Z EH T AH
ZETTIE	Z EH T AY
ZHANE	Z HH EY N
ZIGMUND	Z IH G M AH N D
ZILLAH	Z IH L AH
ZILPAH	Z IH L P AH
ZILPHA	Z IH L F AH
ZINA	Z IH N AH
ZION	Z AY AH N
ZITA	Z IY T AH
ZOA	Z OW AH
ZOE	Z OW IY
ZOEY	Z OW IY
ZOIE	Z OY
ZOLA	Z OW L AH
ZOLLIE	Z AA L AY
ZONA	Z OW N AH
ZORA	Z AO R AH
ZULA	Z UW L AH
