7	S EH V AH N
AMY	EY M IY
BILL	B IH L
CLARA	K L AE R AH
CLARA(2)	K L EH R AH
COKE	K OW K
DR	D R AY V
DR(2)	D AA K T ER
FANTA	F AA N T AH
ICE	AY S
JACK	JH AE K
JOHN	JH AA N
MATT	M AE T
NEO	N IY OW
NEXT	N EH K S T
NEXT(2)	N EH K S
NO	N OW
OASIS	OW EY S IH S
ORANGINA	AO R AE N JH IY N ER
ORANGINA(2)	AO R AE N JH IY N AH
PEPPER	P EH P ER
PEPSI	P EH P S IY
RORY	R AO R IY
ROSE	R OW Z
SALLY	S AE L IY
SCHWEPPS	S K W EH P S
SPRITE	S P R AY T
TEA	T IY
UP	AH P
YES	Y EH S
